Rk	Player	Nation	Pos	Squad	Age	Born	90s	Tkl	TklW	Def 3rd	Mid 3rd	Att 3rd	Tkl	Att	Tkl%	Lost	Blocks	Sh	Pass	Int	Tkl+Int	Clr	Err	Matches
1	James Abankwah	ie IRL	DF	Udinese	19-137	2004	0.1	1	1	0	1	0	0	0		0	0	0	0	0	1	0	0	Matches
2	Oliver Abildgaard	dk DEN	MF	Hellas Verona	26-357	1996	6.5	9	6	5	3	1	6	14	42.9	8	7	1	6	5	14	17	0	Matches
3	Tammy Abraham	eng ENG	FW	Roma	25-243	1997	24.1	17	10	4	8	5	3	15	20.0	12	10	4	6	3	20	14	0	Matches
4	Christian Acella	it ITA	MF	Cremonese	20-330	2002	0.2	1	0	1	0	0	0	2	0.0	2	0	0	0	0	1	0	0	Matches
5	Francesco Acerbi	it ITA	DF	Inter	35-112	1988	26.6	33	19	22	7	4	20	27	74.1	7	23	16	7	41	74	83	2	Matches
6	Yacine Adli	fr FRA	MF,FW	Milan	22-308	2000	1.6	6	3	2	4	0	2	2	100.0	0	2	0	2	1	7	1	0	Matches
7	Michel Aebischer	ch SUI	FW,MF	Bologna	26-147	1997	16.1	12	6	3	6	3	2	17	11.8	15	13	2	11	7	19	9	0	Matches
8	Felix Afena-Gyan	gh GHA	FW,MF	Cremonese	20-134	2003	9.1	7	3	4	1	2	2	10	20.0	8	5	1	4	1	8	6	0	Matches
9	Kevin Agudelo	co COL	MF,FW	Spezia	24-200	1998	23.7	71	38	22	30	19	25	59	42.4	34	39	5	34	10	81	6	0	Matches
10	Ola Aina	ng NGA	DF	Torino	26-237	1996	9.3	16	12	5	8	3	9	15	60.0	6	12	2	10	10	26	26	0	Matches
11	Emanuel Aiwum	at AUT	DF	Cremonese	22-159	2000	17.4	54	33	35	17	2	32	46	69.6	14	28	16	12	24	78	51	3	Matches
12	Jean-Daniel Akpa-Akpro	ci CIV	MF,FW	Empoli	30-234	1992	14.1	50	34	24	19	7	20	37	54.1	17	34	4	30	13	63	26	0	Matches
13	Luis Alberto	es ESP	MF	Lazio	30-247	1992	26.1	45	27	18	18	9	21	70	30.0	49	32	6	26	9	54	4	0	Matches
14	Agustín Álvarez Martínez	uy URU	FW,MF	Sassuolo	22-014	2001	4.1	6	3	0	5	1	1	4	25.0	3	5	1	4	3	9	3	0	Matches
15	Kelvin Amian	fr FRA	DF	Spezia	25-114	1998	25.4	52	31	31	12	9	23	30	76.7	7	33	12	21	22	74	82	1	Matches
16	Bruno Amione	ar ARG	DF	Hellas Verona	21-150	2002	0.6	1	1	1	0	0	1	2	50.0	1	1	0	1	0	1	4	0	Matches
17	Bruno Amione	ar ARG	DF	Sampdoria	21-150	2002	22.2	47	30	33	14	0	17	41	41.5	24	24	11	13	22	69	57	1	Matches
18	Ethan Ampadu	wls WAL	DF,MF	Spezia	22-261	2000	28.3	65	36	32	28	5	16	39	41.0	23	45	22	23	34	99	90	0	Matches
19	Sofyan Amrabat	ma MAR	MF	Fiorentina	26-285	1996	21.3	38	24	14	17	7	16	28	57.1	12	22	5	17	21	59	16	2	Matches
20	Felipe Anderson	br BRA	FW	Lazio	30-048	1993	31.9	76	47	29	40	7	28	82	34.1	54	54	6	48	28	104	27	0	Matches
21	Janis Antiste	fr FRA	FW	Sassuolo	20-288	2002	0.6	1	0	1	0	0	1	1	100.0	0	0	0	0	0	1	0	0	Matches
22	Marcos Antônio	br BRA	MF	Lazio	22-354	2000	6.6	9	6	4	5	0	9	20	45.0	11	7	2	5	11	20	18	0	Matches
23	Valentin Antov	bg BUL	DF	Monza	22-205	2000	3.3	6	5	3	3	0	1	5	20.0	4	5	4	1	2	8	12	1	Matches
24	Marko Arnautović	at AUT	FW	Bologna	34-044	1989	16.2	9	6	2	5	2	1	6	16.7	5	11	1	10	2	11	9	0	Matches
25	Tolgay Arslan	de GER	MF	Udinese	32-290	1990	12.9	26	17	11	14	1	12	35	34.3	23	19	0	19	12	38	9	1	Matches
26	Arthur	br BRA	FW	Fiorentina	25-038	1998	14.9	8	2	1	3	4	4	8	50.0	4	10	1	9	1	9	12	0	Matches
27	Santiago Ascacíbar	ar ARG	MF	Cremonese	26-097	1997	8.1	29	14	17	10	2	14	35	40.0	21	14	2	12	13	42	11	0	Matches
28	Kristoffer Askildsen	no NOR	MF	Lecce	22-144	2001	8.1	7	3	2	3	2	4	10	40.0	6	15	4	11	11	18	6	0	Matches
29	Kristjan Asllani	al ALB	MF	Inter	21-085	2002	6.5	11	5	1	8	2	7	10	70.0	3	3	1	2	6	17	4	0	Matches
30	Emil Audero	it ITA	GK	Sampdoria	26-135	1997	25.0	0	0	0	0	0	0	2	0.0	2	0	0	0	0	0	7	1	Matches
31	Tommaso Augello	it ITA	DF	Sampdoria	28-276	1994	33.0	17	14	13	2	2	9	20	45.0	11	23	7	16	16	33	59	1	Matches
32	Kaan Ayhan	tr TUR	DF	Sassuolo	28-204	1994	6.1	10	4	6	4	0	7	7	100.0	0	5	4	1	5	15	26	1	Matches
33	Jaime Báez	uy URU	DF	Cremonese	28-038	1995	1.1	4	2	3	0	1	3	6	50.0	3	0	0	0	0	4	2	1	Matches
34	Nedim Bajrami	al ALB	MF,FW	Empoli	24-094	1999	10.4	8	4	3	3	2	4	6	66.7	2	5	0	5	7	15	4	0	Matches
35	Nedim Bajrami	al ALB	FW	Sassuolo	24-094	1999	8.7	12	7	6	2	4	5	11	45.5	6	9	1	8	7	19	6	0	Matches
36	Tiemoué Bakayoko	fr FRA	MF	Milan	28-289	1994	0.5	5	5	4	1	0	3	3	100.0	0	0	0	0	0	5	0	1	Matches
37	Tommaso Baldanzi	it ITA	MF	Empoli	20-071	2003	19.7	25	12	9	13	3	7	32	21.9	25	21	1	20	2	27	5	0	Matches
38	Fodé Ballo-Touré	sn SEN	DF	Milan	26-150	1997	5.8	14	9	7	6	1	7	10	70.0	3	11	3	8	2	16	3	0	Matches
39	Lameck Banda	zm ZAM	FW,MF	Lecce	22-124	2001	17.6	29	19	13	13	3	14	39	35.9	25	23	2	21	8	37	5	0	Matches
40	Filippo Bandinelli	it ITA	MF	Empoli	28-065	1995	24.3	53	33	18	26	9	16	42	38.1	26	20	7	13	17	70	39	0	Matches
41	Antonín Barák	cz CZE	MF	Hellas Verona	28-181	1994	0.3	0	0	0	0	0	0	0		0	0	0	0	0	0	0	0	Matches
42	Antonín Barák	cz CZE	MF	Fiorentina	28-181	1994	20.0	21	9	5	7	9	6	16	37.5	10	16	2	14	3	24	13	0	Matches
43	Andrea Barberis	it ITA	MF	Monza	29-173	1993	3.8	7	2	4	3	0	5	11	45.5	6	0	0	0	8	15	1	0	Matches
44	Tommaso Barbieri	it ITA	DF	Juventus	20-280	2002	1.2	3	3	3	0	0	3	8	37.5	5	3	0	3	0	3	2	0	Matches
45	Francesco Bardi	it ITA	GK	Bologna	31-135	1992	1.0	0	0	0	0	0	0	0		0	0	0	0	0	0	0	0	Matches
46	Nicolò Barella	it ITA	MF	Inter	26-115	1997	28.6	48	25	17	25	6	27	51	52.9	24	29	5	24	11	59	10	0	Matches
47	Enzo Barrenechea	ar ARG	MF	Juventus	22-011	2001	1.8	8	3	3	4	1	3	5	60.0	2	3	0	3	2	10	3	0	Matches
48	Musa Barrow	gm GAM	FW,MF	Bologna	24-200	1998	21.1	20	4	10	5	5	8	14	57.1	6	25	1	24	1	21	7	0	Matches
49	Federico Baschirotto	it ITA	DF	Lecce	26-255	1996	36.0	40	30	35	5	0	22	35	62.9	13	45	29	16	36	76	186	0	Matches
50	Toma Bašić	hr CRO	MF	Lazio	26-189	1996	5.7	6	4	4	1	1	3	8	37.5	5	9	0	9	7	13	8	0	Matches
51	Alberto Basso	it ITA	MF	Cremonese	18-338	2004	0.2	0	0	0	0	0	0	0		0	0	0	0	0	0	0	0	Matches
52	Alessandro Bastoni	it ITA	DF	Inter	24-050	1999	23.3	41	20	20	14	7	11	27	40.7	16	25	11	14	23	64	44	0	Matches
53	Simone Bastoni	it ITA	MF,DF	Spezia	26-209	1996	13.2	47	24	23	19	5	15	33	45.5	18	20	5	15	8	55	14	0	Matches
54	Brian Bayeye	fr FRA	DF	Torino	22-337	2000	0.7	3	0	3	0	0	1	1	100.0	0	1	1	0	1	4	2	0	Matches
55	Rodrigo Becão	br BRA	DF	Udinese	27-134	1996	27.6	70	36	50	17	3	40	53	75.5	13	44	24	20	26	96	68	2	Matches
56	Julius Beck	dk DEN	MF	Spezia	18-036	2005	0.1	2	1	1	1	0	0	0		0	0	0	0	0	2	0	0	Matches
57	Raoul Bellanova	it ITA	DF	Inter	23-016	2000	5.3	13	6	11	1	1	8	13	61.5	5	6	1	5	4	17	14	0	Matches
58	Andrea Belotti	it ITA	FW	Roma	29-164	1993	12.0	12	5	3	5	4	5	11	45.5	6	11	1	10	3	15	4	0	Matches
59	Marco Benassi	it ITA	DF	Fiorentina	28-267	1994	1.0	3	3	2	0	1	3	4	75.0	1	0	0	0	1	4	1	0	Matches
60	Marco Benassi	it ITA	MF	Cremonese	28-267	1994	11.1	26	15	9	11	6	15	24	62.5	9	13	1	12	12	38	19	0	Matches
61	Ismaël Bennacer	dz ALG	MF	Milan	25-183	1997	22.3	59	33	26	31	2	30	51	58.8	21	25	7	18	26	85	16	1	Matches
62	Domenico Berardi	it ITA	FW	Sassuolo	28-305	1994	19.8	23	14	8	10	5	9	38	23.7	29	13	0	13	18	41	18	0	Matches
63	Bartosz Bereszyński	pl POL	DF	Sampdoria	30-325	1992	13.3	28	18	15	11	2	17	26	65.4	9	18	4	14	21	49	25	0	Matches
64	Bartosz Bereszyński	pl POL	DF	Napoli	30-325	1992	1.7	3	2	1	1	1	2	2	100.0	0	4	0	4	3	6	3	0	Matches
65	Beto	gw GNB	FW	Udinese	25-122	1998	22.8	16	9	0	9	7	4	16	25.0	12	17	3	14	5	21	26	0	Matches
66	Matteo Bianchetti	it ITA	DF	Cremonese	30-077	1993	22.8	32	19	21	9	2	20	32	62.5	12	30	17	13	18	50	110	0	Matches
67	Alessandro Bianco	it ITA	MF	Fiorentina	20-244	2002	1.6	5	2	2	3	0	2	3	66.7	1	1	0	1	0	5	0	0	Matches
68	Jaka Bijol	si SVN	DF	Udinese	24-117	1999	30.3	39	23	32	7	0	16	27	59.3	11	41	25	16	29	68	165	0	Matches
69	Cristiano Biraghi	it ITA	DF	Fiorentina	30-274	1992	28.3	65	38	29	29	7	32	65	49.2	33	32	7	25	14	79	42	1	Matches
70	Samuele Birindelli	it ITA	DF	Monza	23-318	1999	15.3	34	18	20	10	4	17	28	60.7	11	28	8	20	15	49	30	0	Matches
71	Kristijan Bistrović	hr CRO	MF	Lecce	25-054	1998	5.1	3	1	3	0	0	0	5	0.0	5	3	0	3	0	3	4	0	Matches
72	Alexis Blin	fr FRA	MF	Lecce	26-259	1996	25.4	69	39	27	33	9	38	72	52.8	34	53	15	38	33	102	74	0	Matches
73	Jeremie Boga	ci CIV	MF,FW	Atalanta	26-150	1997	8.7	9	5	3	2	4	2	5	40.0	3	6	0	6	1	10	1	0	Matches
74	Emil Bohinen	no NOR	MF	Salernitana	24-082	1999	8.6	25	13	15	8	2	12	22	54.5	10	23	6	17	16	41	21	0	Matches
75	Giacomo Bonaventura	it ITA	MF	Fiorentina	33-284	1989	20.9	35	23	14	15	6	24	37	64.9	13	14	0	14	16	51	5	1	Matches
76	Federico Bonazzoli	it ITA	FW,MF	Salernitana	26-012	1997	12.4	5	3	0	3	2	0	9	0.0	9	9	1	8	3	8	0	0	Matches
77	Warren Bondo	fr FRA	MF	Monza	19-260	2003	0.7	1	0	1	0	0	0	0		0	1	0	1	0	1	0	0	Matches
78	Kevin Bonifazi	it ITA	DF	Bologna	27-014	1996	9.0	12	8	7	5	0	6	12	50.0	6	9	7	2	11	23	32	0	Matches
79	Leonardo Bonucci	it ITA	DF	Juventus	36-032	1987	8.8	5	4	1	4	0	2	4	50.0	2	11	8	3	12	17	28	0	Matches
80	Erik Botheim	no NOR	MF,FW	Salernitana	23-143	2000	8.9	11	7	3	4	4	6	11	54.5	5	3	0	3	0	11	3	0	Matches
81	Mehdi Bourabia	ma MAR	MF	Spezia	31-299	1991	29.8	40	19	13	22	5	18	39	46.2	21	38	12	26	30	70	55	0	Matches
82	Edoardo Bove	it ITA	MF	Roma	21-017	2002	10.3	34	17	11	15	8	15	38	39.5	23	14	1	13	9	43	9	0	Matches
83	Jayden Braaf	nl NED	MF,FW	Hellas Verona	20-275	2002	3.2	5	3	2	3	0	0	0		0	1	0	1	2	7	1	0	Matches
84	Domagoj Bradarić	hr CRO	DF	Salernitana	23-174	1999	25.0	26	19	14	8	4	7	16	43.8	9	20	5	15	21	47	44	0	Matches
85	Josip Brekalo	hr CRO	FW,MF	Fiorentina	24-344	1998	2.5	2	1	0	1	1	1	4	25.0	3	1	0	1	1	3	1	0	Matches
86	Gleison Bremer	br BRA	DF	Juventus	26-076	1997	29.3	29	20	23	5	1	19	26	73.1	7	44	22	22	42	71	120	2	Matches
87	Dylan Bronn	tn TUN	DF	Salernitana	27-348	1995	18.7	34	18	17	16	1	20	30	66.7	10	32	20	12	20	54	58	1	Matches
88	Marcelo Brozović	hr CRO	MF	Inter	30-198	1992	18.7	37	22	13	22	2	11	37	29.7	26	22	7	15	22	59	26	0	Matches
89	Cristian Buonaiuto	it ITA	MF,FW	Cremonese	30-155	1992	10.4	24	15	8	10	6	12	26	46.2	14	11	0	11	14	38	7	0	Matches
90	Alessandro Buongiorno	it ITA	DF	Torino	23-361	1999	29.2	38	25	22	16	0	16	29	55.2	13	37	19	18	55	93	102	2	Matches
91	Leonardo Buta	pt POR	DF	Udinese	20-362	2002	0.1	0	0	0	0	0	0	0		0	0	0	0	0	0	0	0	Matches
92	Juan Cabal	co COL	DF	Hellas Verona	22-145	2001	4.0	9	6	7	2	0	6	9	66.7	3	7	5	2	10	19	10	0	Matches
93	Liberato Cacace	nz NZL	DF	Empoli	22-248	2000	5.5	22	9	11	6	5	9	14	64.3	5	10	5	5	4	26	13	0	Matches
94	Davide Calabria	it ITA	DF	Milan	26-178	1996	17.8	70	44	31	31	8	38	61	62.3	23	20	6	14	25	95	34	0	Matches
95	Mattia Caldara	it ITA	DF	Spezia	29-028	1994	13.9	23	14	10	11	2	9	20	45.0	11	23	16	7	17	40	88	2	Matches
96	Luca Caldirola	it ITA	DF	Monza	32-121	1991	25.1	25	13	18	4	3	12	25	48.0	13	30	17	13	24	49	64	0	Matches
97	Hakan Çalhanoğlu	tr TUR	MF	Inter	29-114	1994	25.7	46	25	17	24	5	15	42	35.7	27	30	5	25	24	70	13	1	Matches
98	Mohamed Camara	gn GUI	MF	Roma	26-094	1997	7.7	13	10	3	7	3	5	15	33.3	10	5	1	4	10	23	8	0	Matches
99	Nicolò Cambiaghi	it ITA	FW,MF	Empoli	22-156	2000	13.3	29	21	10	12	7	7	25	28.0	18	15	1	14	7	36	8	0	Matches
100	Andrea Cambiaso	it ITA	DF	Bologna	23-102	2000	23.1	55	32	33	19	3	26	60	43.3	34	26	2	24	26	81	32	1	Matches
101	Matteo Cancellieri	it ITA	FW	Lazio	21-110	2002	2.8	10	4	5	3	2	5	9	55.6	4	4	0	4	1	11	2	0	Matches
102	Antonio Candreva	it ITA	MF,DF	Salernitana	36-094	1987	29.3	17	7	13	2	2	11	37	29.7	26	7	3	4	17	34	32	0	Matches
103	Gianluca Caprari	it ITA	MF,FW	Monza	29-307	1993	26.2	16	6	3	11	2	8	26	30.8	18	21	1	20	7	23	3	0	Matches
104	Francesco Caputo	it ITA	FW	Sampdoria	35-300	1987	12.2	3	1	0	0	3	0	3	0.0	3	0	0	0	1	4	3	0	Matches
105	Francesco Caputo	it ITA	FW	Empoli	35-300	1987	19.0	2	2	0	1	1	0	1	0.0	1	7	2	5	2	4	8	0	Matches
106	Andrea Carboni	it ITA	DF	Monza	22-118	2001	1.9	3	2	2	0	1	2	5	40.0	3	3	2	1	3	6	2	1	Matches
107	Franco Carboni	it ITA	DF,FW	Monza	20-059	2003	0.7	1	1	1	0	0	0	2	0.0	2	3	0	3	1	2	0	0	Matches
108	Valentin Carboni	ar ARG	MF,DF	Inter	18-089	2005	0.3	1	1	0	1	0	1	3	33.3	2	1	0	1	0	1	0	0	Matches
109	Carlos	br BRA	DF	Monza	24-146	1999	33.3	67	34	38	21	8	32	53	60.4	21	24	6	18	24	91	84	1	Matches
110	Marco Carnesecchi	it ITA	GK	Cremonese	22-336	2000	27.0	1	1	1	0	0	1	2	50.0	1	0	0	0	0	1	11	2	Matches
111	Nicolò Casale	it ITA	DF	Lazio	25-108	1998	26.9	41	19	27	14	0	21	33	63.6	12	25	17	8	17	58	72	1	Matches
112	Tommaso Cassandro	it ITA	DF	Lecce	23-144	2000	0.1	1	1	0	1	0	0	0		0	1	1	0	0	1	0	0	Matches
113	Michele Castagnetti	it ITA	MF	Cremonese	33-157	1989	14.9	44	19	20	22	2	17	51	33.3	34	13	4	9	15	59	22	0	Matches
114	Gaetano Castrovilli	it ITA	MF	Fiorentina	26-105	1997	7.0	10	8	1	7	2	2	9	22.2	7	4	1	3	7	17	3	0	Matches
115	Danilo Cataldi	it ITA	MF	Lazio	28-300	1994	21.1	24	15	7	14	3	14	40	35.0	26	23	9	14	24	48	32	0	Matches
116	Pietro Ceccaroni	it ITA	DF	Lecce	27-163	1995	0.5	0	0	0	0	0	0	0		0	1	1	0	3	3	2	0	Matches
117	Federico Ceccherini	it ITA	DF	Hellas Verona	31-022	1992	15.8	25	19	15	9	1	13	23	56.5	10	17	10	7	19	44	55	0	Matches
118	Assan Ceesay	gm GAM	FW	Lecce	29-077	1994	19.6	22	17	7	7	8	8	16	50.0	8	15	2	13	3	25	24	0	Matches
119	Emil Ceide	no NOR	FW	Sassuolo	21-272	2001	5.1	4	1	4	0	0	3	5	60.0	2	3	1	2	1	5	0	0	Matches
120	Zeki Çelik	tr TUR	DF	Roma	26-105	1997	16.2	41	21	19	20	2	24	40	60.0	16	32	6	26	14	55	35	2	Matches
121	Michele Cerofolini	it ITA	GK	Fiorentina	24-149	1999	4.0	0	0	0	0	0	0	0		0	0	0	0	1	1	2	0	Matches
122	Federico Chiesa	it ITA	DF,FW	Juventus	25-220	1997	8.6	21	10	6	6	9	5	13	38.5	8	13	1	12	0	21	1	0	Matches
123	Vlad Chiricheș	ro ROU	DF	Cremonese	33-200	1989	10.8	33	19	25	7	1	14	22	63.6	8	36	23	13	22	55	44	0	Matches
124	Daniel Ciofani	it ITA	FW	Cremonese	37-306	1985	11.3	6	3	1	2	3	4	7	57.1	3	6	1	5	2	8	9	0	Matches
125	Tio Cipot	si SVN	FW,DF	Spezia	20-043	2003	1.5	9	7	3	3	3	5	7	71.4	2	0	0	0	0	9	2	0	Matches
126	Patrick Ciurria	it ITA	DF,MF	Monza	28-113	1995	29.7	29	17	18	10	1	15	31	48.4	16	23	2	21	6	35	32	0	Matches
127	Omar Colley	gm GAM	DF	Sampdoria	30-221	1992	15.4	17	10	10	7	0	9	12	75.0	3	9	5	4	22	39	69	1	Matches
128	Lorenzo Colombo	it ITA	FW	Lecce	21-086	2002	16.3	17	9	1	9	7	6	13	46.2	7	22	0	22	2	19	6	0	Matches
129	Andrea Colpani	it ITA	MF	Monza	24-022	1999	9.8	14	9	6	5	3	8	12	66.7	4	14	2	12	3	17	4	0	Matches
130	Andrea Consigli	it ITA	GK	Sassuolo	36-126	1987	35.0	1	0	1	0	0	0	1	0.0	1	0	0	0	0	1	13	3	Matches
131	Andrea Conti	it ITA	DF	Sampdoria	29-092	1994	0.3	0	0	0	0	0	0	0		0	0	0	0	0	0	0	0	Matches
132	Diego Coppola	it ITA	DF	Hellas Verona	19-156	2003	13.1	25	17	15	10	0	11	24	45.8	13	20	6	14	14	39	38	0	Matches
133	Joaquín Correa	ar ARG	FW	Inter	28-293	1994	10.6	12	7	3	6	3	4	15	26.7	11	4	1	3	3	15	0	0	Matches
134	Alessandro Cortinovis	it ITA	MF	Hellas Verona	22-128	2001	0.1	1	0	1	0	0	0	0		0	1	0	1	0	1	0	0	Matches
135	Lassana Coulibaly	ml MLI	MF	Salernitana	27-053	1996	31.1	83	49	42	34	7	30	70	42.9	40	34	6	28	23	106	33	2	Matches
136	Alessio Cragno	it ITA	GK	Monza	28-339	1994	1.0	0	0	0	0	0	0	1	0.0	1	0	0	0	0	0	0	0	Matches
137	Bryan Cristante	it ITA	MF,DF	Roma	28-091	1995	31.6	110	60	53	48	9	54	89	60.7	35	39	10	29	18	128	52	0	Matches
138	Domen Črnigoj	si SVN	MF	Salernitana	27-196	1995	3.3	8	3	0	7	1	1	2	50.0	1	9	1	8	9	17	6	0	Matches
139	Juan Cuadrado	co COL	DF,FW	Juventus	35-007	1988	22.1	48	33	33	13	2	26	63	41.3	37	15	2	13	24	72	30	0	Matches
140	Mickaël Cuisance	fr FRA	MF	Sampdoria	23-290	1999	6.9	13	10	7	5	1	5	23	21.7	18	10	0	10	5	18	4	0	Matches
141	Marco D'Alessandro	it ITA	DF,FW	Monza	32-105	1991	3.2	4	4	3	1	0	2	5	40.0	3	2	0	2	1	5	3	0	Matches
142	Danilo D'Ambrosio	it ITA	DF	Inter	34-266	1988	8.1	25	17	17	7	1	15	27	55.6	12	12	4	8	10	35	17	0	Matches
143	Luca D'Andrea	it ITA	FW	Sassuolo	18-269	2004	3.5	4	0	2	1	1	1	4	25.0	3	2	0	2	1	5	1	0	Matches
144	Flavius Daniliuc	at AUT	DF	Salernitana	22-036	2001	23.4	55	27	36	16	3	26	46	56.5	20	30	13	17	28	83	75	0	Matches
145	Danilo	br BRA	DF	Juventus	31-322	1991	34.4	87	57	58	21	8	48	68	70.6	20	38	20	18	45	132	111	1	Matches
146	Matteo Darmian	it ITA	DF	Inter	33-182	1989	21.5	53	29	27	14	12	30	44	68.2	14	33	5	28	21	74	33	0	Matches
147	Paweł Dawidowicz	pl POL	DF	Hellas Verona	28-013	1995	18.1	47	30	27	17	3	21	29	72.4	8	14	9	5	22	69	71	0	Matches
148	Charles De Ketelaere	be BEL	MF,FW	Milan	22-084	2001	12.2	25	11	7	13	5	12	29	41.4	17	14	2	12	4	29	9	0	Matches
149	Manuel De Luca	it ITA	FW,MF	Sampdoria	24-320	1998	0.5	0	0	0	0	0	0	0		0	0	0	0	0	0	0	0	Matches
150	Mattia De Sciglio	it ITA	DF	Juventus	30-225	1992	11.6	14	7	8	3	3	9	14	64.3	5	9	3	6	4	18	20	0	Matches
151	Lorenzo De Silvestri	it ITA	DF	Bologna	35-010	1988	7.3	2	2	1	0	1	2	6	33.3	4	5	5	0	3	5	20	0	Matches
152	Koni De Winter	be BEL	DF	Empoli	20-355	2002	11.4	14	9	11	3	0	5	13	38.5	8	14	12	2	6	20	65	0	Matches
153	Grégoire Defrel	mq MTQ	FW	Sassuolo	31-350	1991	12.6	9	7	5	2	2	4	12	33.3	8	11	0	11	2	11	5	0	Matches
154	Duccio Degl'Innocenti	it ITA	MF	Empoli	20-035	2003	0.0	0	0	0	0	0	0	0		0	0	0	0	1	1	0	0	Matches
155	Merih Demiral	tr TUR	DF	Atalanta	25-089	1998	17.0	41	29	30	11	0	26	36	72.2	10	24	7	17	24	65	57	1	Matches
156	Diego Demme	de GER	MF	Napoli	31-193	1991	1.5	1	0	1	0	0	0	4	0.0	4	2	0	2	0	1	1	0	Matches
157	Fabio Depaoli	it ITA	DF	Hellas Verona	26-039	1997	23.1	46	27	25	14	7	23	41	56.1	18	31	6	25	16	62	30	3	Matches
158	Fabio Depaoli	it ITA	DF,MF	Sampdoria	26-039	1997	1.5	5	3	2	3	0	3	4	75.0	1	1	0	1	1	6	4	0	Matches
159	Kastriot Dermaku	al ALB	DF	Lecce	31-138	1992	0.4	0	0	0	0	0	0	0		0	0	0	0	0	0	0	0	Matches
160	Cyriel Dessers	ng NGA	FW	Cremonese	28-176	1994	17.6	11	4	4	4	3	2	6	33.3	4	14	2	12	3	14	5	0	Matches
161	Sergiño Dest	us USA	DF	Milan	22-211	2000	3.7	12	6	3	5	4	3	4	75.0	1	1	0	1	4	16	2	0	Matches
162	Mattia Destro	it ITA	FW,MF	Empoli	32-074	1991	6.2	1	1	0	1	0	0	0		0	2	0	2	1	2	5	0	Matches
163	Gerard Deulofeu	es ESP	FW	Udinese	29-081	1994	13.5	8	5	5	1	2	5	15	33.3	10	8	1	7	2	10	1	0	Matches
164	Samuel Di Carmine	it ITA	FW,MF	Cremonese	34-246	1988	0.3	0	0	0	0	0	0	0		0	0	0	0	0	0	0	0	Matches
165	Federico Di Francesco	it ITA	FW,MF	Lecce	28-353	1994	22.6	28	16	7	11	10	9	19	47.4	10	16	0	16	8	36	14	0	Matches
166	Michele Di Gregorio	it ITA	GK	Monza	25-310	1997	36.0	0	0	0	0	0	0	2	0.0	2	0	0	0	4	4	17	3	Matches
167	Giovanni Di Lorenzo	it ITA	DF	Napoli	29-302	1993	35.2	60	29	33	19	8	25	48	52.1	23	30	9	21	29	89	60	0	Matches
168	Ángel Di María	ar ARG	FW,MF	Juventus	35-108	1988	14.8	10	5	3	5	2	3	18	16.7	15	15	0	15	7	17	0	0	Matches
169	Boulaye Dia	sn SEN	FW,MF	Salernitana	26-198	1996	28.0	12	5	3	6	3	2	7	28.6	5	10	0	10	7	19	27	1	Matches
170	Brahim Díaz	es ESP	MF,FW	Milan	23-303	1999	20.6	29	13	5	19	5	5	15	33.3	10	11	0	11	7	36	5	0	Matches
171	Federico Dimarco	it ITA	DF	Inter	25-204	1997	23.0	31	25	6	18	7	9	19	47.4	10	15	4	11	18	49	20	0	Matches
172	Koffi Djidji	ci CIV	DF	Torino	30-184	1992	26.9	50	25	32	17	1	18	32	56.3	14	29	14	15	34	84	72	0	Matches
173	Berat Djimsiti	al ALB	DF	Atalanta	30-103	1993	19.0	33	18	21	12	0	17	24	70.8	7	16	7	9	35	68	72	1	Matches
174	Dodô	br BRA	DF	Fiorentina	24-197	1998	25.1	38	21	19	14	5	21	43	48.8	22	24	2	22	25	63	36	0	Matches
175	Josh Doig	sct SCO	DF	Hellas Verona	21-015	2002	15.0	19	8	6	7	6	6	16	37.5	10	25	6	19	11	30	13	1	Matches
176	Nicolás Domínguez	ar ARG	MF	Bologna	24-339	1998	25.5	79	49	34	33	12	39	76	51.3	37	29	3	26	21	100	29	1	Matches
177	Giulio Donati	it ITA	DF	Monza	33-117	1990	4.7	4	1	1	1	2	3	6	50.0	3	3	1	2	4	8	11	0	Matches
178	Bartłomiej Drągowski	pl POL	GK	Spezia	25-287	1997	32.7	1	0	1	0	0	1	5	20.0	4	0	0	0	1	2	15	3	Matches
179	Ondrej Duda	sk SVK	MF	Hellas Verona	28-179	1994	11.8	22	14	7	12	3	9	16	56.3	7	11	0	11	13	35	8	0	Matches
180	Denzel Dumfries	nl NED	DF	Inter	27-045	1996	23.6	33	17	15	13	5	21	33	63.6	12	30	8	22	12	45	26	0	Matches
181	Alfred Duncan	gh GHA	MF	Fiorentina	30-084	1993	11.6	17	10	0	16	1	10	20	50.0	10	9	0	9	8	25	6	0	Matches
182	Paulo Dybala	ar ARG	MF,FW	Roma	29-199	1993	18.3	14	4	1	8	5	8	26	30.8	18	11	0	11	8	22	4	0	Matches
183	Edin Džeko	ba BIH	FW	Inter	37-077	1986	18.8	3	2	0	3	0	0	4	0.0	4	15	1	14	3	6	24	0	Matches
184	Festy Ebosele	ie IRL	DF	Udinese	20-304	2002	4.6	15	10	8	7	0	4	10	40.0	6	5	0	5	2	17	5	0	Matches
185	Enzo Ebosse	cm CMR	DF	Udinese	24-083	1999	10.3	15	9	11	4	0	9	13	69.2	4	27	6	21	11	26	29	0	Matches
186	Tyronne Ebuehi	ng NGA	DF	Empoli	27-168	1995	21.4	22	14	11	7	4	9	13	69.2	4	23	12	11	12	34	79	1	Matches
187	Éderson	br BRA	MF	Atalanta	23-330	1999	23.6	67	34	18	42	7	29	62	46.8	33	54	7	47	34	101	30	0	Matches
188	Kingsley Ehizibue	nl NED	DF	Udinese	28-008	1995	17.1	47	31	28	13	6	29	45	64.4	16	21	3	18	10	57	42	1	Matches
189	Albin Ekdal	se SWE	MF	Spezia	33-309	1989	19.2	37	20	14	20	3	19	45	42.2	26	24	2	22	26	63	36	0	Matches
190	Emmanuel Ekong	se SWE	FW,MF	Empoli	20-342	2002	0.2	0	0	0	0	0	0	0		0	0	0	0	0	0	0	0	Matches
191	Mikael Ellertsson	is ISL	MF,DF	Spezia	21-083	2002	1.9	4	2	1	3	0	0	3	0.0	3	2	1	1	2	6	0	0	Matches
192	Elif Elmas	mk MKD	FW,MF	Napoli	23-251	1999	17.3	24	13	8	12	4	11	22	50.0	11	15	2	13	11	35	5	0	Matches
193	Martin Erlic	hr CRO	DF	Sassuolo	25-129	1998	25.9	27	16	18	8	1	10	23	43.5	13	36	23	13	31	58	120	1	Matches
194	Gonzalo Escalante	ar ARG	MF	Cremonese	30-067	1993	6.2	16	8	8	8	0	10	13	76.9	3	7	1	6	10	26	4	0	Matches
195	Salvatore Esposito	it ITA	MF	Spezia	22-238	2000	9.8	14	11	7	5	2	5	19	26.3	14	9	1	8	11	25	18	0	Matches
196	Nicolò Fagioli	it ITA	MF	Juventus	22-110	2001	16.9	29	19	12	15	2	8	27	29.6	19	16	2	14	8	37	7	1	Matches
197	Wladimiro Falcone	it ITA	GK	Lecce	28-051	1995	37.0	2	0	2	0	0	2	2	100.0	0	0	0	0	2	4	21	3	Matches
198	Davide Faraoni	it ITA	DF	Hellas Verona	31-220	1991	15.5	32	22	18	12	2	15	39	38.5	24	28	10	18	15	47	36	0	Matches
199	Federico Fazio	ar ARG	DF	Salernitana	36-077	1987	11.9	15	12	8	7	0	4	11	36.4	7	9	4	5	28	43	61	0	Matches
200	Jacopo Fazzini	it ITA	MF	Empoli	20-078	2003	8.3	27	15	17	8	2	16	32	50.0	16	14	2	12	7	34	19	0	Matches
201	Lewis Ferguson	sct SCO	MF,FW	Bologna	23-282	1999	25.4	44	25	16	20	8	20	40	50.0	20	22	7	15	19	63	24	0	Matches
202	Alex Ferrari	it ITA	DF	Sampdoria	28-336	1994	9.6	9	5	7	2	0	4	8	50.0	4	21	10	11	19	28	25	0	Matches
203	Alex Ferrari	it ITA	DF	Cremonese	28-336	1994	11.2	40	23	32	7	1	28	42	66.7	14	19	4	15	25	65	45	1	Matches
204	Salvador Ferrer	es ESP	DF	Spezia	25-132	1998	1.5	4	2	2	2	0	1	3	33.3	2	3	1	2	1	5	4	0	Matches
205	Vincenzo Fiorillo	it ITA	GK	Salernitana	33-140	1990	1.0	0	0	0	0	0	0	0		0	0	0	0	0	0	0	0	Matches
206	Alessandro Florenzi	it ITA	DF	Milan	32-083	1991	2.2	6	4	3	2	1	4	6	66.7	2	1	0	1	3	9	2	0	Matches
207	Davide Frattesi	it ITA	MF	Sassuolo	23-223	1999	31.9	63	36	24	29	10	25	44	56.8	19	27	6	21	16	79	42	0	Matches
208	Matteo Gabbia	it ITA	DF	Milan	23-224	1999	6.8	17	10	12	5	0	6	8	75.0	2	8	3	5	5	22	29	0	Matches
209	Manolo Gabbiadini	it ITA	FW,MF	Sampdoria	31-188	1991	25.2	22	14	7	9	6	8	21	38.1	13	13	1	12	5	27	24	0	Matches
210	Gianluca Gaetano	it ITA	MF	Napoli	23-028	2000	0.6	4	3	1	3	0	0	0		0	1	0	1	1	5	0	0	Matches
211	Roberto Gagliardini	it ITA	MF	Inter	29-056	1994	7.7	16	6	9	6	1	10	21	47.6	11	14	5	9	2	18	12	0	Matches
212	Adolfo Gaich	ar ARG	FW	Hellas Verona	24-096	1999	7.9	5	3	0	3	2	1	6	16.7	5	7	2	5	3	8	7	1	Matches
213	Pablo Galdames Millán	cl CHI	MF	Cremonese	26-154	1996	8.0	14	10	8	3	3	5	33	15.2	28	13	2	11	9	23	13	0	Matches
214	Antonino Gallo	it ITA	DF	Lecce	23-148	2000	26.9	55	35	34	12	9	38	57	66.7	19	36	6	30	12	67	66	0	Matches
215	Federico Gatti	it ITA	DF	Juventus	24-343	1998	15.1	15	11	9	4	2	9	15	60.0	6	18	12	6	19	34	50	2	Matches
216	Valentin Gendrey	fr FRA	DF	Lecce	22-346	2000	33.4	87	56	53	25	9	39	70	55.7	31	45	4	41	36	123	86	0	Matches
217	Paolo Ghiglione	it ITA	DF	Cremonese	26-120	1997	7.0	13	9	9	3	1	8	17	47.1	9	9	4	5	4	17	11	0	Matches
218	Mario Gila	es ESP	DF	Lazio	22-277	2000	1.0	3	1	3	0	0	0	1	0.0	1	0	0	0	3	6	3	0	Matches
219	Gvidas Gineitis	lt LTU	MF	Torino	19-048	2004	1.5	3	1	0	2	1	1	2	50.0	1	0	0	0	0	3	1	0	Matches
220	Olivier Giroud	fr FRA	FW	Milan	36-245	1986	22.8	8	5	2	4	2	2	10	20.0	8	10	3	7	3	11	22	0	Matches
221	Pierluigi Gollini	it ITA	GK	Fiorentina	28-076	1995	3.0	1	0	1	0	0	1	1	100.0	0	0	0	0	0	1	2	0	Matches
222	Pierluigi Gollini	it ITA	GK	Napoli	28-076	1995	4.0	0	0	0	0	0	0	0		0	0	0	0	0	0	1	0	Matches
223	Joan Gonzàlez	es ESP	MF	Lecce	21-121	2002	24.4	48	28	20	18	10	17	51	33.3	34	37	8	29	16	64	28	0	Matches
224	Nicolás González	ar ARG	FW,MF	Fiorentina	25-057	1998	14.7	17	10	3	10	4	5	16	31.3	11	14	0	14	4	21	6	0	Matches
225	Robin Gosens	de GER	DF	Inter	28-332	1994	12.3	32	16	13	10	9	14	24	58.3	10	16	2	14	23	55	14	0	Matches
226	Alberto Grassi	it ITA	MF	Empoli	28-087	1995	12.6	26	21	13	13	0	15	23	65.2	8	21	12	9	27	53	44	0	Matches
227	Andrew Gravillon	gp GLP	DF	Torino	25-114	1998	3.5	3	3	0	3	0	0	0		0	4	2	2	9	12	16	0	Matches
228	Koray Günter	de GER	DF	Hellas Verona	28-290	1994	11.1	10	6	1	8	1	4	7	57.1	3	24	15	9	30	40	46	0	Matches
229	Koray Günter	de GER	DF	Sampdoria	28-290	1994	8.1	9	7	5	4	0	6	9	66.7	3	9	4	5	11	20	39	0	Matches
230	Emmanuel Gyasi	gh GHA	FW,DF	Spezia	29-142	1994	30.3	24	15	11	10	3	9	34	26.5	25	24	6	18	8	32	24	0	Matches
231	Norbert Gyömbér	sk SVK	DF	Salernitana	30-334	1992	18.5	31	22	24	6	1	15	23	65.2	8	33	22	11	33	64	90	0	Matches
232	Christian Gytkjær	dk DEN	FW,MF	Monza	33-027	1990	6.2	6	2	1	4	1	2	5	40.0	3	6	1	5	0	6	2	0	Matches
233	Nicolas Haas	ch SUI	MF	Empoli	27-130	1996	12.7	27	13	16	6	5	12	24	50.0	12	16	4	12	8	35	27	0	Matches
234	Samir Handanović	si SVN	GK	Inter	38-323	1984	13.0	0	0	0	0	0	0	0		0	0	0	0	0	0	5	0	Matches
235	Abdou Harroui	nl NED	MF	Sassuolo	25-140	1998	6.2	15	5	5	6	4	2	7	28.6	5	6	1	5	1	16	9	0	Matches
236	Hans Hateboer	nl NED	DF	Atalanta	29-144	1994	15.5	21	13	11	8	2	11	27	40.7	16	23	4	19	12	33	25	0	Matches
237	Liam Henderson	sct SCO	MF	Empoli	27-038	1996	10.8	13	10	6	5	2	4	20	20.0	16	10	2	8	10	23	9	0	Matches
238	Jack Hendry	sct SCO	DF	Cremonese	28-026	1995	2.4	0	0	0	0	0	0	1	0.0	1	2	1	1	1	1	7	0	Matches
239	Matheus Henrique	br BRA	MF	Sassuolo	25-165	1997	20.6	26	12	9	11	6	12	24	50.0	12	15	4	11	12	38	9	0	Matches
240	Thomas Henry	fr FRA	FW	Hellas Verona	28-255	1994	11.4	5	3	1	1	3	1	5	20.0	4	6	2	4	0	5	14	0	Matches
241	Theo Hernández	fr FRA	DF	Milan	25-239	1997	29.8	43	24	27	15	1	22	37	59.5	15	33	7	26	20	63	31	1	Matches
242	Isak Hien	se SWE	DF	Hellas Verona	24-140	1999	28.0	70	33	51	19	0	36	59	61.0	23	36	15	21	28	98	89	1	Matches
243	Morten Hjulmand	dk DEN	MF	Lecce	23-342	1999	31.9	85	49	47	38	0	37	67	55.2	30	42	10	32	71	156	53	0	Matches
244	Emil Holm	se SWE	DF	Spezia	23-020	2000	15.5	26	15	13	8	5	16	31	51.6	15	21	6	15	9	35	41	0	Matches
245	Martin Hongla	cm CMR	MF	Hellas Verona	25-078	1998	5.8	8	5	4	4	0	5	5	100.0	0	7	1	6	6	14	9	0	Matches
246	Petko Hristov	bg BUL	DF	Spezia	24-093	1999	4.1	6	4	2	4	0	5	8	62.5	3	4	2	2	4	10	12	0	Matches
247	Ajdin Hrustic	au AUS	MF	Hellas Verona	26-332	1996	2.5	2	1	1	1	0	1	2	50.0	1	2	0	2	0	2	2	1	Matches
248	Elseid Hysaj	al ALB	DF	Lazio	29-102	1994	21.2	38	22	23	11	4	22	38	57.9	16	28	6	22	20	58	42	0	Matches
249	Rasmus Højlund	dk DEN	FW	Atalanta	20-118	2003	19.5	4	3	0	2	2	1	6	16.7	5	9	1	8	1	5	5	0	Matches
250	Roger Ibanez	br BRA	DF	Roma	24-191	1998	31.1	67	33	38	26	3	32	48	66.7	16	30	11	19	66	133	95	2	Matches
251	Zlatan Ibrahimović	se SWE	FW	Milan	41-242	1981	1.6	0	0	0	0	0	0	0		0	1	1	0	0	0	2	0	Matches
252	Antonio Iervolino	it ITA	MF	Salernitana	20-152	2003	0.1	0	0	0	0	0	0	1	0.0	1	0	0	0	0	0	0	0	Matches
253	Igor	br BRA	DF	Fiorentina	25-115	1998	22.9	43	29	21	18	4	20	27	74.1	7	33	14	19	25	68	56	2	Matches
254	Jonathan Ikone	fr FRA	FW	Fiorentina	25-031	1998	21.5	15	7	5	5	5	4	13	30.8	9	18	1	17	4	19	3	0	Matches
255	Ivan Ilić	rs SRB	MF	Hellas Verona	22-077	2001	9.5	16	10	9	7	0	6	11	54.5	5	10	1	9	8	24	14	0	Matches
256	Ivan Ilić	rs SRB	MF	Torino	22-077	2001	12.2	18	7	6	11	1	10	20	50.0	10	11	3	8	5	23	10	0	Matches
257	Samuel Iling-Junior	eng ENG	DF,FW	Juventus	19-241	2003	3.0	7	2	3	1	3	4	8	50.0	4	5	1	4	1	8	5	0	Matches
258	Emirhan İlkhan	tr TUR	MF	Torino	19-001	2004	1.0	1	1	0	1	0	1	1	100.0	0	3	1	2	2	3	2	0	Matches
259	Emirhan İlkhan	tr TUR	MF	Sampdoria	19-001	2004	1.2	5	3	1	2	2	1	2	50.0	1	5	1	4	0	5	3	0	Matches
260	Ciro Immobile	it ITA	FW	Lazio	33-102	1990	23.7	11	5	4	4	3	6	9	66.7	3	9	1	8	1	12	14	0	Matches
261	Ardian Ismajli	al ALB	DF	Empoli	26-245	1996	23.3	40	32	25	15	0	18	24	75.0	6	47	31	16	27	67	120	0	Matches
262	Armando Izzo	it ITA	DF	Monza	31-092	1992	26.7	72	49	43	27	2	29	45	64.4	16	29	17	12	50	122	86	1	Matches
263	Mato Jajalo	ba BIH	MF	Udinese	35-008	1988	0.7	0	0	0	0	0	0	1	0.0	1	0	0	0	0	0	2	0	Matches
264	Jesé	es ESP	FW	Sampdoria	30-096	1993	2.3	2	0	0	2	0	0	1	0.0	1	3	1	2	1	3	2	0	Matches
265	Juan Jesus	br BRA	DF	Napoli	31-357	1991	10.4	16	11	9	6	1	9	12	75.0	3	18	11	7	10	26	29	0	Matches
266	Þórir Jóhann Helgason	is ISL	MF	Lecce	22-247	2000	2.5	2	2	1	0	1	2	3	66.7	1	3	1	2	3	5	3	0	Matches
267	Luka Jović	rs SRB	FW,MF	Fiorentina	25-161	1997	17.0	6	3	1	4	1	2	8	25.0	6	7	2	5	2	8	10	0	Matches
268	Hamed Junior Traorè	ci CIV	MF,FW	Sassuolo	23-106	2000	6.6	11	6	4	6	1	4	11	36.4	7	4	0	4	2	13	0	1	Matches
269	Yayah Kallon	sl SLE	MF,FW	Hellas Verona	21-337	2001	9.6	14	10	5	4	5	7	12	58.3	5	10	0	10	8	22	5	0	Matches
270	Pierre Kalulu	fr FRA	DF	Milan	22-362	2000	28.3	57	39	33	21	3	28	42	66.7	14	41	17	24	41	98	56	1	Matches
271	Yann Karamoh	fr FRA	MF,FW	Torino	24-329	1998	7.6	5	2	3	2	0	1	5	20.0	4	5	0	5	0	5	2	1	Matches
272	Rick Karsdorp	nl NED	DF	Roma	28-111	1995	7.9	21	13	11	7	3	13	22	59.1	9	0	0	0	7	28	15	1	Matches
273	Denso Kasius	nl NED	DF	Bologna	20-239	2002	3.8	12	6	7	4	1	8	10	80.0	2	6	3	3	3	15	6	0	Matches
274	Grigoris Kastanos	cy CYP	MF,DF	Salernitana	25-123	1998	13.3	35	21	15	18	2	14	36	38.9	22	19	5	14	8	43	7	0	Matches
275	Moise Kean	it ITA	FW	Juventus	23-094	2000	10.9	8	6	2	5	1	3	7	42.9	4	4	0	4	5	13	2	0	Matches
276	Jakub Kiwior	pl POL	DF	Spezia	23-107	2000	16.0	22	17	15	7	0	6	24	25.0	18	26	18	8	24	46	71	1	Matches
277	Simon Kjær	dk DEN	DF	Milan	34-068	1989	11.2	15	8	9	6	0	7	11	63.6	4	14	11	3	9	24	35	1	Matches
278	Teun Koopmeiners	nl NED	MF	Atalanta	25-094	1998	30.8	45	26	15	24	6	28	55	50.9	27	41	5	36	19	64	36	2	Matches
279	Filip Kostić	rs SRB	DF,FW	Juventus	30-213	1992	28.0	40	25	17	19	4	20	46	43.5	26	30	4	26	16	56	32	0	Matches
280	Christian Kouamé	ci CIV	FW	Fiorentina	25-178	1997	20.1	26	18	8	10	8	7	14	50.0	7	15	3	12	12	38	6	0	Matches
281	Viktor Kovalenko	ua UKR	MF	Spezia	27-108	1996	6.1	9	5	1	6	2	5	8	62.5	3	11	2	9	4	13	7	0	Matches
282	Julian Kristoffersen	no NOR	FW	Salernitana	26-023	1997	0.2	0	0	0	0	0	0	0		0	1	0	1	0	0	0	0	Matches
283	Raimonds Krollis	lv LVA	FW	Spezia	21-217	2001	0.4	1	1	0	0	1	0	1	0.0	1	0	0	0	0	1	0	0	Matches
284	Rade Krunić	ba BIH	MF	Milan	29-238	1993	17.6	40	28	18	18	4	16	50	32.0	34	31	11	20	16	56	21	0	Matches
285	Marash Kumbulla	al ALB	DF	Roma	23-114	2000	2.9	4	4	2	2	0	2	3	66.7	1	2	1	1	4	8	6	0	Matches
286	Khvicha Kvaratskhelia	ge GEO	FW	Napoli	22-110	2001	27.0	40	22	11	7	22	17	41	41.5	24	19	0	19	5	45	6	1	Matches
287	Giorgos Kyriakopoulos	gr GRE	DF,FW	Bologna	27-117	1996	7.8	13	6	4	5	4	10	23	43.5	13	14	2	12	4	17	10	0	Matches
288	Giorgos Kyriakopoulos	gr GRE	FW,DF	Sassuolo	27-117	1996	8.5	21	8	7	9	5	10	14	71.4	4	7	1	6	11	32	12	1	Matches
289	Sam Lammers	nl NED	FW	Sampdoria	26-033	1997	12.2	12	5	2	7	3	6	15	40.0	9	10	3	7	6	18	11	0	Matches
290	Sam Lammers	nl NED	FW	Empoli	26-033	1997	9.8	20	10	5	9	6	7	11	63.6	4	4	1	3	3	23	8	0	Matches
291	Kevin Lasagna	it ITA	FW,MF	Hellas Verona	30-296	1992	17.5	12	6	7	3	2	6	14	42.9	8	17	1	16	5	17	13	0	Matches
292	Armand Lauriente	fr FRA	FW	Sassuolo	24-180	1998	24.2	21	15	5	7	9	8	21	38.1	13	20	0	20	12	33	8	0	Matches
293	Valentino Lazaro	at AUT	DF	Torino	27-070	1996	15.3	10	5	6	0	4	6	14	42.9	8	16	3	13	3	13	29	0	Matches
294	Marko Lazetić	rs SRB	FW	Milan	19-131	2004	0.1	0	0	0	0	0	0	0		0	0	0	0	0	0	0	0	Matches
295	Darko Lazović	rs SRB	DF,MF	Hellas Verona	32-260	1990	24.6	24	13	9	12	3	13	28	46.4	15	13	3	10	16	40	19	0	Matches
296	Manuel Lazzari	it ITA	DF	Lazio	29-185	1993	20.9	33	21	13	14	6	21	36	58.3	15	20	6	14	18	51	36	1	Matches
297	Rafael Leão	pt POR	FW,MF	Milan	23-357	1999	25.9	6	5	1	3	2	4	11	36.4	7	6	2	4	14	20	8	0	Matches
298	Mehdi Léris	dz ALG	MF,DF	Sampdoria	25-010	1998	26.3	62	45	29	24	9	23	55	41.8	32	37	6	31	27	89	31	0	Matches
299	Karol Linetty	pl POL	MF	Torino	28-120	1995	20.7	32	17	7	22	3	13	25	52.0	12	28	8	20	18	50	25	0	Matches
300	Marcin Listkowski	pl POL	MF,FW	Lecce	25-112	1998	0.9	0	0	0	0	0	0	0		0	0	0	0	3	3	2	0	Matches
301	Diego Llorente	es ESP	DF	Roma	29-290	1993	5.9	8	3	6	2	0	4	11	36.4	7	4	2	2	10	18	18	0	Matches
302	Stanislav Lobotka	sk SVK	MF	Napoli	28-189	1994	33.5	81	44	33	35	13	43	71	60.6	28	29	7	22	23	104	16	0	Matches
303	Manuel Locatelli	it ITA	MF	Juventus	25-145	1998	26.2	58	32	25	23	10	30	49	61.2	19	49	22	27	27	85	56	0	Matches
304	Luka Lochoshvili	ge GEO	DF	Cremonese	25-004	1998	20.4	45	19	30	11	4	22	31	71.0	9	31	10	21	22	67	89	0	Matches
305	Ademola Lookman	ng NGA	FW,MF	Atalanta	25-225	1997	18.9	12	4	2	6	4	3	14	21.4	11	18	0	18	4	16	1	0	Matches
306	Maxime Lopez	fr FRA	MF	Sassuolo	25-180	1997	24.9	42	18	26	12	4	16	56	28.6	40	24	6	18	22	64	21	0	Matches
307	Matteo Lovato	it ITA	DF	Salernitana	23-108	2000	9.0	17	14	14	3	0	10	25	40.0	15	8	5	3	13	30	33	2	Matches
308	Sandi Lovrić	si SVN	MF	Udinese	25-066	1998	25.0	40	18	16	16	8	25	43	58.1	18	25	2	23	25	65	20	0	Matches
309	Hirving Lozano	mx MEX	FW	Napoli	27-307	1995	17.8	24	13	10	6	8	9	21	42.9	12	31	0	31	15	39	6	0	Matches
310	Jhon Lucumí	co COL	DF	Bologna	24-341	1998	31.2	53	37	39	13	1	24	43	55.8	19	40	26	14	35	88	99	1	Matches
311	José Luis Palomino	ar ARG	DF	Atalanta	33-148	1990	8.4	23	14	16	7	0	11	19	57.9	8	11	4	7	28	51	20	0	Matches
312	Romelu Lukaku	be BEL	FW	Inter	30-020	1993	17.5	3	1	1	0	2	2	4	50.0	2	2	1	1	0	3	16	0	Matches
313	Saša Lukić	rs SRB	MF	Torino	26-293	1996	13.3	21	14	10	10	1	9	15	60.0	6	17	7	10	13	34	10	0	Matches
314	Sebastiano Luperto	it ITA	DF	Empoli	26-269	1996	33.8	33	18	24	8	1	9	20	45.0	11	53	41	12	42	75	157	1	Matches
315	Charalambos Lykogiannis	gr GRE	DF	Bologna	29-223	1993	12.3	16	8	5	6	5	5	13	38.5	8	9	4	5	15	31	30	0	Matches
316	Giulio Maggiore	it ITA	MF	Salernitana	25-082	1998	9.6	20	8	11	6	3	10	21	47.6	11	19	4	15	8	28	10	0	Matches
317	Giangiacomo Magnani	it ITA	DF	Hellas Verona	27-241	1995	16.0	32	22	19	11	2	18	24	75.0	6	20	15	5	21	53	70	0	Matches
318	Mike Maignan	fr FRA	GK	Milan	27-334	1995	21.0	1	0	1	0	0	1	1	100.0	0	0	0	0	1	2	9	1	Matches
319	Jordan Majchrzak	pl POL	FW	Roma	18-237	2004	0.2	0	0	0	0	0	0	0		0	0	0	0	0	0	0	0	Matches
320	Jean-Victor Makengo	fr FRA	MF	Udinese	24-355	1998	8.9	16	13	7	7	2	5	9	55.6	4	8	2	6	9	25	3	0	Matches
321	Lorenzo Malagrida	it ITA	MF,DF	Sampdoria	19-221	2003	0.7	1	0	0	0	1	1	3	33.3	2	1	0	1	0	1	1	0	Matches
322	Daniel Maldini	it ITA	FW,MF	Spezia	21-234	2001	7.0	12	5	3	4	5	4	11	36.4	7	9	0	9	1	13	8	0	Matches
323	Youssef Maleh	it ITA	MF	Fiorentina	24-284	1998	3.3	3	1	0	3	0	0	4	0.0	4	5	0	5	1	4	3	0	Matches
324	Youssef Maleh	it ITA	MF	Lecce	24-284	1998	7.1	16	7	3	6	7	6	14	42.9	8	19	1	18	5	21	10	0	Matches
325	Ruslan Malinovskyi	ua UKR	MF,FW	Atalanta	30-029	1993	6.1	14	8	5	6	3	6	17	35.3	11	8	1	7	5	19	2	0	Matches
326	Gianluca Mancini	it ITA	DF	Roma	27-046	1996	30.9	34	17	25	8	1	15	31	48.4	16	38	17	21	45	79	65	0	Matches
327	Rolando Mandragora	it ITA	MF	Fiorentina	25-338	1997	21.7	42	24	12	22	8	23	52	44.2	29	25	3	22	16	58	21	0	Matches
328	Federico Marchetti	it ITA	GK	Spezia	40-115	1983	0.7	0	0	0	0	0	0	0		0	0	0	0	0	0	0	0	Matches
329	Riccardo Marchizza	it ITA	DF	Sassuolo	25-068	1998	3.0	2	2	1	1	0	2	4	50.0	2	2	0	2	1	3	6	0	Matches
330	Gian Marco Ferrari	it ITA	DF	Sassuolo	31-107	1992	24.2	23	16	11	10	2	10	17	58.8	7	29	20	9	23	46	80	4	Matches
331	Pablo Marí	es ESP	DF	Monza	29-275	1993	26.6	34	16	28	6	0	17	25	68.0	8	22	14	8	30	64	108	3	Matches
332	Răzvan Marin	ro ROU	MF	Empoli	27-010	1996	28.2	44	22	22	21	1	19	40	47.5	21	29	11	18	14	58	33	0	Matches
333	Marlon	br BRA	DF	Monza	27-268	1995	17.7	35	21	20	14	1	15	29	51.7	14	13	4	9	18	53	50	0	Matches
334	Luca Marrone	it ITA	DF	Monza	33-066	1990	1.5	0	0	0	0	0	0	2	0.0	2	2	2	0	0	0	4	1	Matches
335	Lautaro Martínez	ar ARG	FW	Inter	25-284	1997	28.0	25	14	3	15	7	7	23	30.4	16	31	1	30	12	37	16	1	Matches
336	Lucas Martínez Quarta	ar ARG	DF	Fiorentina	27-023	1996	23.1	80	48	44	32	4	42	61	68.9	19	39	18	21	46	126	76	1	Matches
337	Adam Marušić	me MNE	DF	Lazio	30-228	1992	30.7	41	30	23	14	4	25	39	64.1	14	20	6	14	38	79	63	1	Matches
338	Adam Masina	ma MAR	DF	Udinese	29-151	1994	8.8	10	7	7	3	0	6	15	40.0	9	11	4	7	10	20	28	1	Matches
339	Nemanja Matić	rs SRB	MF	Roma	34-305	1988	20.3	47	27	24	19	4	19	33	57.6	14	26	6	20	25	72	21	1	Matches
340	Luís Maximiano	pt POR	GK	Lazio	24-148	1999	0.1	0	0	0	0	0	0	0		0	0	0	0	0	0	0	0	Matches
341	Pasquale Mazzocchi	it ITA	DF	Salernitana	27-310	1995	20.7	30	17	20	4	6	15	35	42.9	20	10	2	8	10	40	36	2	Matches
342	Weston McKennie	us USA	MF,DF	Juventus	24-278	1998	11.7	14	5	3	9	2	5	8	62.5	3	15	4	11	11	25	15	1	Matches
343	Gary Medel	cl CHI	MF,DF	Bologna	35-303	1987	15.7	25	15	16	7	2	9	16	56.3	7	15	8	7	27	52	34	0	Matches
344	Soualiho Meïté	fr FRA	MF	Cremonese	29-077	1994	25.3	45	29	23	15	7	22	44	50.0	22	26	6	20	27	72	36	0	Matches
345	Alex Meret	it ITA	GK	Napoli	26-072	1997	33.0	0	0	0	0	0	0	0		0	0	0	0	0	0	6	1	Matches
346	Yıldırım Mert Çetin	tr TUR	DF	Lecce	26-152	1997	0.2	1	0	1	0	0	0	0		0	0	0	0	1	2	1	0	Matches
347	Junior Messias	br BRA	FW,DF	Milan	32-020	1991	15.7	22	17	8	9	5	5	18	27.8	13	20	4	16	7	29	27	0	Matches
348	Tommaso Milanese	it ITA	MF	Cremonese	20-306	2002	0.3	0	0	0	0	0	0	0		0	1	1	0	0	0	0	0	Matches
349	Nikola Milenković	rs SRB	DF	Fiorentina	25-233	1997	23.7	40	25	20	17	3	18	27	66.7	9	27	14	13	22	62	72	0	Matches
350	Arkadiusz Milik	pl POL	FW	Juventus	29-094	1994	16.8	11	8	1	8	2	2	8	25.0	6	9	0	9	1	12	14	0	Matches
351	Sergej Milinković-Savić	rs SRB	MF	Lazio	28-095	1995	32.6	55	32	21	22	12	23	65	35.4	42	47	11	36	28	83	47	0	Matches
352	Vanja Milinković-Savić	rs SRB	GK	Torino	26-102	1997	37.0	2	1	2	0	0	2	2	100.0	0	0	0	0	1	3	19	1	Matches
353	Kim Min-jae	kr KOR	DF	Napoli	26-199	1996	33.9	55	30	32	22	1	25	29	86.2	4	36	26	10	41	96	123	1	Matches
354	Aleksei Miranchuk	ru RUS	MF	Torino	27-228	1995	22.2	11	5	3	4	4	3	11	27.3	8	11	0	11	2	13	4	0	Matches
355	Fabio Miretti	it ITA	MF,FW	Juventus	19-303	2003	13.0	22	10	14	5	3	10	25	40.0	15	20	1	19	3	25	11	0	Matches
356	Filippo Missori	it ITA	DF	Roma	19-070	2004	2.0	4	3	3	0	1	3	6	50.0	3	0	0	0	3	7	5	0	Matches
357	Henrikh Mkhitaryan	am ARM	MF	Inter	34-132	1989	22.1	41	26	13	22	6	14	41	34.1	27	27	4	23	21	62	18	0	Matches
358	Salvatore Molina	it ITA	DF	Monza	31-152	1992	2.5	6	5	2	4	0	4	5	80.0	1	4	2	2	1	7	2	0	Matches
359	Daniele Montevago	it ITA	FW	Sampdoria	20-076	2003	2.6	1	0	0	0	1	0	1	0.0	1	2	1	1	0	1	1	0	Matches
360	Lorenzo Montipò	it ITA	GK	Hellas Verona	27-102	1996	36.0	1	0	1	0	0	0	2	0.0	2	1	0	1	0	1	26	3	Matches
361	Nikola Moro	hr CRO	MF	Bologna	25-082	1998	12.6	32	21	11	15	6	14	36	38.9	22	15	2	13	8	40	18	0	Matches
362	Dany Mota	pt POR	FW,MF	Monza	25-031	1998	20.6	8	7	1	3	4	2	10	20.0	8	5	1	4	6	14	25	0	Matches
363	João Moutinho	pt POR	DF,FW	Spezia	25-141	1998	0.6	7	1	5	1	1	3	4	75.0	1	1	1	0	0	7	0	0	Matches
364	Mert Müldür	tr TUR	DF	Sassuolo	24-060	1999	0.1	0	0	0	0	0	0	0		0	0	0	0	0	0	0	0	Matches
365	Luis Muriel	co COL	FW,MF	Atalanta	32-047	1991	11.8	9	6	2	3	4	5	16	31.3	11	9	0	9	2	11	2	0	Matches
366	Jeison Murillo	co COL	DF	Sampdoria	31-006	1992	11.7	22	11	16	6	0	17	26	65.4	9	22	14	8	8	30	39	0	Matches
367	Nicola Murru	it ITA	DF	Sampdoria	28-168	1994	7.7	23	13	15	7	1	7	13	53.8	6	16	6	10	8	31	20	0	Matches
368	Juan Musso	ar ARG	GK	Atalanta	29-027	1994	23.1	1	1	1	0	0	1	1	100.0	0	0	0	0	0	1	11	1	Matches
369	Joakim Mæhle	dk DEN	DF,MF	Atalanta	26-013	1997	23.6	30	17	12	5	13	21	38	55.3	17	28	6	22	23	53	26	0	Matches
370	Herculano Nabian	pt POR	MF	Empoli	19-128	2004	0.0	0	0	0	0	0	0	0		0	0	0	0	0	0	0	0	Matches
371	Michel Ndary Adopo	fr FRA	MF,DF	Torino	22-318	2000	2.9	7	2	4	2	1	1	3	33.3	2	2	2	0	1	8	4	0	Matches
372	Tanguy Ndombele	fr FRA	MF	Napoli	26-156	1996	9.0	14	8	4	8	2	4	7	57.1	3	10	1	9	7	21	7	1	Matches
373	Ilija Nestorovski	mk MKD	FW	Udinese	33-082	1990	6.9	7	3	2	1	4	5	11	45.5	6	6	1	5	2	9	10	0	Matches
374	Cyril Ngonge	be BEL	MF,FW	Hellas Verona	23-007	2000	7.4	7	3	2	2	3	3	11	27.3	8	6	0	6	6	13	4	0	Matches
375	Hans Nicolussi Caviglia	it ITA	MF	Salernitana	22-349	2000	6.2	14	6	5	7	2	8	13	61.5	5	9	0	9	7	21	7	1	Matches
376	Dimitris Nikolaou	gr GRE	DF	Spezia	24-293	1998	31.9	45	32	31	10	4	25	37	67.6	12	40	25	15	27	72	82	0	Matches
377	Bram Nuytinck	nl NED	DF	Udinese	33-029	1990	4.3	7	4	3	4	0	4	8	50.0	4	6	6	0	5	12	22	0	Matches
378	Bram Nuytinck	nl NED	DF	Sampdoria	33-029	1990	16.6	54	38	33	21	0	23	34	67.6	11	36	21	15	23	77	84	0	Matches
379	M'Bala Nzola	ao ANG	FW	Spezia	26-288	1996	28.5	12	5	0	6	6	3	9	33.3	6	20	6	14	6	18	20	0	Matches
380	Pedro Obiang	gq EQG	MF	Sassuolo	31-067	1992	9.7	26	17	12	12	2	10	18	55.6	8	12	2	10	8	34	15	0	Matches
381	Guillermo Ochoa	mx MEX	GK	Salernitana	37-324	1985	19.0	0	0	0	0	0	0	2	0.0	2	0	0	0	0	0	9	0	Matches
382	Marios Oikonomou	gr GRE	DF	Sampdoria	30-239	1992	2.4	3	2	3	0	0	1	3	33.3	2	5	4	1	4	7	13	0	Matches
383	David Okereke	ng NGA	FW,MF	Cremonese	25-277	1997	24.7	12	8	4	5	3	3	16	18.8	13	23	3	20	9	21	12	0	Matches
384	Caleb Okoli	it ITA	DF	Atalanta	21-324	2001	10.3	21	17	14	6	1	10	25	40.0	15	10	5	5	29	50	44	3	Matches
385	Mathías Olivera	uy URU	DF	Napoli	25-214	1997	18.3	39	23	16	16	7	22	43	51.2	21	28	2	26	22	61	26	0	Matches
386	André Onana	cm CMR	GK	Inter	27-061	1996	24.0	0	0	0	0	0	0	1	0.0	1	0	0	0	0	0	5	0	Matches
387	Divock Origi	be BEL	FW	Milan	28-045	1995	11.4	10	5	4	3	3	5	10	50.0	5	6	2	4	0	10	13	0	Matches
388	Riccardo Orsolini	it ITA	FW	Bologna	26-129	1997	22.9	30	19	15	10	5	17	41	41.5	24	29	3	26	8	38	17	0	Matches
389	Victor Osimhen	ng NGA	FW	Napoli	24-155	1998	27.7	10	6	1	2	7	0	7	0.0	7	6	1	5	6	16	29	0	Matches
390	Remi Oudin	fr FRA	FW,MF	Lecce	26-196	1996	13.7	25	13	9	12	4	10	23	43.5	13	16	2	14	28	53	23	0	Matches
391	Adam Ounas	dz ALG	FW	Napoli	26-203	1996	0.2	0	0	0	0	0	0	0		0	0	0	0	1	1	0	0	Matches
392	Simone Pafundi	it ITA	MF,FW	Udinese	17-108	2006	0.9	8	5	1	5	2	2	4	50.0	2	0	0	0	1	9	0	0	Matches
393	Flavio Paoletti	it ITA	MF	Sampdoria	20-137	2003	2.2	2	2	0	2	0	1	4	25.0	3	1	0	1	5	7	7	0	Matches
394	Leandro Paredes	ar ARG	MF	Juventus	28-338	1994	10.7	19	13	7	11	1	10	21	47.6	11	8	0	8	17	36	22	0	Matches
395	Fabiano Parisi	it ITA	DF	Empoli	22-205	2000	31.4	65	35	37	21	7	30	72	41.7	42	51	16	35	41	106	91	0	Matches
396	Mario Pašalić	hr CRO	MF,FW	Atalanta	28-113	1995	19.0	22	10	6	14	2	6	20	30.0	14	21	4	17	21	43	13	0	Matches
397	Patric	es ESP	DF	Lazio	30-046	1993	14.7	15	10	10	3	2	9	14	64.3	5	17	12	5	10	25	51	1	Matches
398	Rui Patrício	pt POR	GK	Roma	35-107	1988	35.0	1	1	1	0	0	1	1	100.0	0	0	0	0	2	3	6	3	Matches
399	Pedro	es ESP	FW	Lazio	35-309	1987	20.4	31	21	14	10	7	10	27	37.0	17	17	2	15	6	37	4	1	Matches
400	Gianluca Pegolo	it ITA	GK	Sassuolo	42-069	1981	2.0	0	0	0	0	0	0	1	0.0	1	0	0	0	0	0	1	0	Matches
401	Pietro Pellegri	it ITA	FW	Torino	22-077	2001	5.1	6	2	1	3	2	2	3	66.7	1	4	1	3	0	6	4	0	Matches
402	Lorenzo Pellegrini	it ITA	MF	Roma	26-348	1996	27.3	51	29	24	24	3	22	48	45.8	26	27	4	23	26	77	21	0	Matches
403	Luca Pellegrini	it ITA	DF	Lazio	24-087	1999	1.0	0	0	0	0	0	0	2	0.0	2	1	0	1	3	3	0	0	Matches
404	Pepín	gq EQG	MF	Monza	26-292	1996	12.4	27	18	10	11	6	8	25	32.0	17	14	3	11	13	40	17	0	Matches
405	Roberto Pereyra	ar ARG	DF,MF	Udinese	32-146	1991	30.3	36	20	21	12	3	16	43	37.2	27	19	4	15	16	52	27	0	Matches
406	Nehuén Pérez	ar ARG	DF	Udinese	22-343	2000	30.3	73	38	52	19	2	37	51	72.5	14	50	21	29	35	108	103	1	Matches
407	Simone Perilli	it ITA	GK	Hellas Verona	28-146	1995	1.0	0	0	0	0	0	0	0		0	0	0	0	0	0	0	0	Matches
408	Mattia Perin	it ITA	GK	Juventus	30-204	1992	10.5	0	0	0	0	0	0	0		0	0	0	0	0	0	0	0	Matches
409	Samuele Perisan	it ITA	GK	Empoli	25-285	1997	7.0	0	0	0	0	0	0	0		0	0	0	0	0	0	2	0	Matches
410	Matteo Pessina	it ITA	MF	Monza	26-042	1997	31.6	55	34	27	20	8	24	59	40.7	35	47	14	33	36	91	32	1	Matches
411	Andrea Petagna	it ITA	FW	Monza	27-337	1995	18.1	7	5	2	3	2	3	6	50.0	3	16	4	12	3	10	18	0	Matches
412	Giuseppe Pezzella	it ITA	DF	Lecce	25-185	1997	10.0	21	9	16	2	3	9	16	56.3	7	11	3	8	8	29	31	1	Matches
413	Krzysztof Piątek	pl POL	FW	Salernitana	27-336	1995	22.8	17	10	3	8	6	5	21	23.8	16	17	4	13	2	19	37	0	Matches
414	Roberto Piccoli	it ITA	FW	Hellas Verona	22-126	2001	2.1	1	0	1	0	0	0	2	0.0	2	2	0	2	0	1	2	0	Matches
415	Roberto Piccoli	it ITA	FW	Empoli	22-126	2001	4.9	1	1	1	0	0	0	3	0.0	3	3	1	2	1	2	8	0	Matches
416	Charles Pickel	ch SUI	MF	Cremonese	26-018	1997	26.6	51	22	24	23	4	29	54	53.7	25	36	5	31	22	73	36	1	Matches
417	Andrea Pinamonti	it ITA	FW	Sassuolo	24-014	1999	23.2	10	7	0	5	5	3	7	42.9	4	19	2	17	2	12	10	0	Matches
418	Lorenzo Pirola	it ITA	DF	Salernitana	21-102	2002	20.6	32	28	17	14	1	18	26	69.2	8	49	34	15	29	61	83	1	Matches
419	Niccolò Pisilli	it ITA	MF	Roma	18-252	2004	0.0	0	0	0	0	0	0	0		0	0	0	0	0	0	0	0	Matches
420	Marko Pjaca	hr CRO	MF,FW	Empoli	28-027	1995	5.8	4	3	3	1	0	3	5	60.0	2	3	0	3	3	7	3	0	Matches
421	Tommaso Pobega	it ITA	MF	Milan	23-322	1999	9.6	23	12	7	12	4	11	18	61.1	7	11	4	7	8	31	11	0	Matches
422	Paul Pogba	fr FRA	MF,FW	Juventus	30-079	1993	1.2	0	0	0	0	0	0	1	0.0	1	0	0	0	0	0	2	0	Matches
423	Matteo Politano	it ITA	FW	Napoli	29-303	1993	13.0	18	9	9	5	4	11	25	44.0	14	6	0	6	7	25	7	0	Matches
424	Marin Pongračić	hr CRO	DF	Lecce	25-264	1997	8.8	16	14	8	7	1	5	7	71.4	2	4	3	1	16	32	31	0	Matches
425	Stefan Posch	at AUT	DF	Bologna	26-019	1997	27.3	79	41	39	29	11	42	71	59.2	29	42	13	29	33	112	68	0	Matches
426	Ivan Provedel	it ITA	GK	Lazio	29-077	1994	36.9	1	0	1	0	0	0	0		0	0	0	0	0	1	15	1	Matches
427	Ignacio Pussetto	ar ARG	MF,DF	Sampdoria	27-163	1995	1.7	6	3	2	3	1	3	4	75.0	1	4	0	4	0	6	3	0	Matches
428	Niklas Pyyhtiä	fi FIN	MF	Bologna	19-250	2003	0.9	1	0	0	1	0	0	1	0.0	1	0	0	0	1	2	2	0	Matches
429	Fabio Quagliarella	it ITA	FW	Sampdoria	40-122	1983	7.9	2	1	1	1	0	1	7	14.3	6	5	1	4	0	2	9	0	Matches
430	Giacomo Quagliata	it ITA	DF	Cremonese	23-103	2000	7.8	10	8	7	1	2	5	11	45.5	6	7	2	5	11	21	8	0	Matches
431	Adrien Rabiot	fr FRA	MF	Juventus	28-060	1995	29.5	63	34	31	22	10	29	56	51.8	27	37	7	30	26	89	44	1	Matches
432	Nemanja Radonjić	rs SRB	MF,FW	Torino	27-107	1996	16.2	2	1	2	0	0	0	4	0.0	4	3	0	3	2	4	4	0	Matches
433	Ivan Radovanović	rs SRB	MF,DF	Salernitana	34-277	1988	7.5	12	4	8	4	0	4	10	40.0	6	9	3	6	7	19	9	1	Matches
434	Ionuț Radu	ro ROU	GK	Cremonese	26-005	1997	9.0	0	0	0	0	0	0	0		0	0	0	0	0	0	1	3	Matches
435	Ștefan Radu	ro ROU	FW	Lazio	36-223	1986	0.0	0	0	0	0	0	0	0		0	0	0	0	0	0	0	0	Matches
436	Antonio Raimondo	it ITA	FW	Bologna	19-076	2004	0.2	0	0	0	0	0	0	0		0	0	0	0	0	0	1	0	Matches
437	Luca Ranieri	it ITA	DF	Fiorentina	24-040	1999	4.6	8	4	5	3	0	5	8	62.5	3	4	2	2	10	18	13	1	Matches
438	Andrea Ranocchia	it ITA	DF	Monza	35-106	1988	0.5	3	1	1	2	0	3	4	75.0	1	5	5	0	0	3	7	0	Matches
439	Filippo Ranocchia	it ITA	MF	Monza	22-019	2001	5.9	11	6	5	4	2	4	12	33.3	8	5	1	4	4	15	7	0	Matches
440	Giacomo Raspadori	it ITA	FW,MF	Napoli	23-104	2000	9.8	10	8	0	6	4	4	10	40.0	6	9	0	9	4	14	4	0	Matches
441	Giacomo Raspadori	it ITA	FW	Sassuolo	23-104	2000	0.5	0	0	0	0	0	0	0		0	0	0	0	0	0	0	0	Matches
442	Nicola Ravaglia	it ITA	GK	Sampdoria	34-172	1988	9.0	0	0	0	0	0	0	1	0.0	1	0	0	0	0	0	7	0	Matches
443	Ante Rebić	hr CRO	FW,MF	Milan	29-254	1993	10.9	10	8	1	3	6	3	11	27.3	8	6	1	5	1	11	5	0	Matches
444	Arkadiusz Reca	pl POL	DF	Spezia	27-350	1995	23.1	41	25	22	11	8	17	30	56.7	13	19	5	14	24	65	53	0	Matches
445	Panagiotis Retsos	gr GRE	DF	Hellas Verona	24-297	1998	1.4	5	4	2	2	1	3	3	100.0	0	4	1	3	2	7	3	0	Matches
446	Franck Ribéry	fr FRA	MF	Salernitana	40-056	1983	0.4	0	0	0	0	0	0	0		0	1	0	1	0	0	0	0	Matches
447	Samuele Ricci	it ITA	MF	Torino	21-285	2001	22.2	32	21	17	10	5	18	23	78.3	5	19	5	14	17	49	27	1	Matches
448	Tomás Rincón	ve VEN	MF	Sampdoria	35-140	1988	27.4	55	26	21	26	8	29	59	49.2	30	35	6	29	29	84	18	0	Matches
449	Pablo Rodríguez	es ESP	FW,MF	Lecce	21-302	2001	0.6	2	1	2	0	0	0	2	0.0	2	3	0	3	0	2	0	0	Matches
450	Ricardo Rodríguez	ch SUI	DF	Torino	30-281	1992	29.0	53	33	30	16	7	27	41	65.9	14	29	14	15	38	91	61	0	Matches
451	Rogério	br BRA	DF	Sassuolo	25-140	1998	32.3	36	21	21	8	7	17	33	51.5	16	32	9	23	37	73	69	0	Matches
452	Filippo Romagna	it ITA	DF	Sassuolo	26-007	1997	0.0	0	0	0	0	0	0	0		0	0	0	0	0	0	0	0	Matches
453	Alessio Romagnoli	it ITA	DF	Lazio	28-141	1995	31.7	32	15	19	13	0	11	22	50.0	11	31	25	6	37	69	106	0	Matches
454	Simone Romagnoli	it ITA	DF	Lecce	33-113	1990	1.9	6	5	3	3	0	2	2	100.0	0	4	1	3	1	7	11	0	Matches
455	Luka Romero	ar ARG	FW	Lazio	18-196	2004	1.7	0	0	0	0	0	0	3	0.0	3	4	0	4	3	3	1	0	Matches
456	Marten de Roon	nl NED	MF	Atalanta	32-065	1991	31.9	76	38	37	34	5	36	79	45.6	43	37	4	33	34	110	57	0	Matches
457	Nicolò Rovella	it ITA	MF	Monza	21-180	2001	18.3	42	28	21	19	2	12	33	36.4	21	20	1	19	40	82	17	0	Matches
458	Nicolò Rovella	it ITA	MF	Juventus	21-180	2001	0.3	1	1	0	1	0	1	1	100.0	0	0	0	0	0	1	0	0	Matches
459	Amir Rrahmani	xk KVX	DF	Napoli	29-098	1994	26.2	33	18	20	13	0	17	25	68.0	8	36	20	16	14	47	77	1	Matches
460	Ruan	br BRA	DF	Sassuolo	23-360	1999	18.1	38	26	25	12	1	19	28	67.9	9	28	16	12	24	62	79	3	Matches
461	Daniele Rugani	it ITA	DF	Juventus	28-308	1994	6.3	7	0	6	1	0	4	4	100.0	0	7	5	2	7	14	32	0	Matches
462	Matteo Ruggeri	it ITA	DF,MF	Atalanta	20-326	2002	9.2	17	12	5	9	3	8	16	50.0	8	14	3	11	12	29	16	0	Matches
463	Mário Rui	pt POR	DF	Napoli	32-006	1991	18.6	31	20	16	11	4	20	40	50.0	20	17	4	13	15	46	24	1	Matches
464	Abdelhamid Sabiri	ma MAR	MF,FW	Sampdoria	26-186	1996	11.9	18	7	5	9	4	4	13	30.8	9	18	4	14	2	20	5	0	Matches
465	Alexis Saelemaekers	be BEL	FW,DF	Milan	23-340	1999	15.5	31	20	12	16	3	19	41	46.3	22	13	1	12	19	50	11	0	Matches
466	Jacopo Sala	it ITA	MF	Spezia	31-179	1991	1.2	1	0	1	0	0	0	2	0.0	2	2	0	2	1	2	2	0	Matches
467	Lazar Samardzic	rs SRB	MF	Udinese	21-098	2002	19.6	33	16	9	20	4	17	42	40.5	25	12	0	12	11	44	15	0	Matches
468	Junior Sambia	fr FRA	DF	Salernitana	26-268	1996	7.6	11	5	6	4	1	6	10	60.0	4	9	3	6	8	19	16	1	Matches
469	Antonio Sanabria	py PAR	FW	Torino	27-090	1996	26.0	11	5	3	3	5	1	7	14.3	6	8	2	6	4	15	7	0	Matches
470	Leandro Sanca	pt POR	FW,MF	Spezia	23-149	2000	0.4	1	1	0	0	1	1	1	100.0	0	0	0	0	0	1	0	0	Matches
471	Alex Sandro	br BRA	DF	Juventus	32-127	1991	19.9	35	20	16	16	3	15	22	68.2	7	27	10	17	15	50	64	1	Matches
472	Nicola Sansone	it ITA	FW	Bologna	31-265	1991	7.9	11	4	5	4	2	5	10	50.0	5	0	0	0	0	11	3	0	Matches
473	Riccardo Saponara	it ITA	FW	Fiorentina	31-163	1991	13.2	10	5	3	6	1	5	9	55.6	4	7	1	6	4	14	9	1	Matches
474	Mouhamadou Sarr	sn SEN	GK	Cremonese	26-148	1997	1.0	0	0	0	0	0	0	0		0	0	0	0	0	0	0	0	Matches
475	Martin Satriano	uy URU	FW	Empoli	22-102	2001	18.9	13	8	5	6	2	6	14	42.9	8	5	0	5	3	16	21	0	Matches
476	Giorgio Scalvini	it ITA	DF	Atalanta	19-173	2003	25.3	53	29	30	17	6	29	55	52.7	26	36	13	23	55	108	57	2	Matches
477	Jerdy Schouten	nl NED	MF	Bologna	26-141	1997	27.9	63	38	28	33	2	27	49	55.1	22	40	17	23	40	103	43	1	Matches
478	Perr Schuurs	nl NED	DF	Torino	23-188	1999	24.9	50	24	29	17	4	14	26	53.8	12	25	15	10	28	78	99	0	Matches
479	Demba Seck	sn SEN	MF,FW	Torino	22-112	2001	5.6	5	2	3	2	0	2	3	66.7	1	3	1	2	1	6	1	0	Matches
480	Jacopo Segre	it ITA	DF	Torino	26-105	1997	0.2	0	0	0	0	0	0	0		0	0	0	0	0	0	0	0	Matches
481	Vivaldo Semedo	pt POR	MF,FW	Udinese	18-125	2005	0.3	0	0	0	0	0	0	0		0	1	0	1	0	0	1	0	Matches
482	Stefano Sensi	it ITA	MF	Monza	27-301	1995	18.0	41	26	25	13	3	18	48	37.5	30	13	3	10	20	61	4	0	Matches
483	Luigi Sepe	it ITA	GK	Salernitana	32-025	1991	17.0	0	0	0	0	0	0	1	0.0	1	0	0	0	0	0	0	0	Matches
484	Leonardo Sernicola	it ITA	DF	Cremonese	25-307	1997	25.6	45	33	25	13	7	29	43	67.4	14	23	6	17	38	83	53	0	Matches
485	Stephan El Shaarawy	it ITA	DF,MF	Roma	30-218	1992	15.9	20	9	8	9	3	6	21	28.6	15	11	1	10	15	35	10	0	Matches
486	Eldor Shomurodov	uz UZB	FW	Spezia	27-338	1995	9.0	5	5	3	1	1	2	11	18.2	9	5	1	4	3	8	4	0	Matches
487	Eldor Shomurodov	uz UZB	FW	Roma	27-338	1995	1.3	1	0	1	0	0	0	2	0.0	2	1	0	1	1	2	0	0	Matches
488	Marco Silvestri	it ITA	GK	Udinese	32-092	1991	37.0	2	1	2	0	0	2	3	66.7	1	0	0	0	1	3	13	1	Matches
489	Giovanni Simeone	ar ARG	FW	Napoli	27-332	1995	4.4	12	3	3	5	4	3	8	37.5	5	2	1	1	1	13	4	0	Matches
490	Wilfried Singo	ci CIV	DF	Torino	22-159	2000	21.9	27	17	14	10	3	12	19	63.2	7	15	2	13	11	38	33	1	Matches
491	Salvatore Sirigu	it ITA	GK	Fiorentina	36-141	1987	1.0	0	0	0	0	0	0	0		0	0	0	0	0	0	1	0	Matches
492	Leo Skiri Østigård	no NOR	DF	Napoli	23-186	1999	3.7	4	1	3	1	0	1	1	100.0	0	3	3	0	5	9	15	1	Matches
493	Łukasz Skorupski	pl POL	GK	Bologna	32-028	1991	36.0	2	1	2	0	0	1	2	50.0	1	0	0	0	0	2	19	2	Matches
494	Milan Škriniar	sk SVK	DF	Inter	28-111	1995	19.7	29	18	14	11	4	18	32	56.3	14	18	13	5	13	42	46	3	Matches
495	Chris Smalling	eng ENG	DF	Roma	33-192	1989	30.2	26	15	16	10	0	13	21	61.9	8	51	36	15	40	66	120	0	Matches
496	Ola Solbakken	no NOR	MF,FW	Roma	24-268	1998	5.6	2	2	1	1	0	2	7	28.6	5	2	0	2	2	4	8	0	Matches
497	Brandon Soppy	fr FRA	DF	Udinese	21-101	2002	1.0	1	1	0	1	0	0	0		0	4	0	4	1	2	1	0	Matches
498	Brandon Soppy	fr FRA	DF	Atalanta	21-101	2002	7.1	8	5	4	4	0	3	9	33.3	6	10	0	10	3	11	7	0	Matches
499	Roberto Soriano	it ITA	FW,MF	Bologna	32-114	1991	14.7	31	16	9	16	6	13	25	52.0	12	23	2	21	6	37	14	0	Matches
500	Joaquin Sosa	uy URU	DF	Bologna	21-143	2002	7.6	6	2	5	1	0	4	18	22.2	14	5	3	2	6	12	31	0	Matches
501	Riccardo Sottil	it ITA	FW	Fiorentina	23-364	1999	9.3	4	3	2	0	2	2	5	40.0	3	2	0	2	0	4	0	0	Matches
502	Matìas Soulé	ar ARG	MF,FW	Juventus	20-048	2003	4.7	7	4	3	2	2	5	7	71.4	2	7	1	6	3	10	3	0	Matches
503	Adama Soumaoro	fr FRA	DF	Bologna	30-349	1992	20.7	25	17	11	12	2	5	7	71.4	2	18	13	5	15	40	75	1	Matches
504	Leonardo Spinazzola	it ITA	DF	Roma	30-069	1993	18.3	15	8	7	6	2	8	22	36.4	14	13	3	10	9	24	25	0	Matches
505	Marco Sportiello	it ITA	GK	Atalanta	31-023	1992	13.9	1	0	1	0	0	1	3	33.3	2	0	0	0	0	1	2	0	Matches
506	Petar Stojanović	si SVN	DF	Empoli	27-238	1995	16.0	40	21	26	10	4	25	42	59.5	17	15	4	11	11	51	55	0	Matches
507	Gabriel Strefezza	br BRA	FW,MF	Lecce	26-045	1997	26.1	46	23	16	20	10	24	50	48.0	26	35	3	32	16	62	15	0	Matches
508	Dávid Strelec	sk SVK	FW	Spezia	22-059	2001	1.9	2	2	0	1	1	2	2	100.0	0	0	0	0	0	2	0	0	Matches
509	Isaac Success	ng NGA	FW	Udinese	27-146	1996	20.2	8	4	2	5	1	3	8	37.5	5	13	2	11	4	12	18	0	Matches
510	Ibrahim Sulemana	gh GHA	MF	Hellas Verona	20-011	2003	6.3	18	13	9	7	2	5	11	45.5	6	7	2	5	11	29	14	0	Matches
511	Mile Svilar	rs SRB	GK	Roma	23-279	1999	2.0	0	0	0	0	0	0	0		0	0	0	0	0	0	0	0	Matches
512	Wojciech Szczęsny	pl POL	GK	Juventus	33-045	1990	26.5	1	0	1	0	0	0	1	0.0	1	0	0	0	0	1	7	0	Matches
513	Benjamin Tahirovic	ba BIH	MF	Roma	20-091	2003	3.9	8	5	5	2	1	4	12	33.3	8	9	4	5	3	11	3	0	Matches
514	Adrien Tameze	cm CMR	MF	Hellas Verona	29-118	1994	32.7	49	28	21	24	4	26	61	42.6	35	48	13	35	35	84	52	2	Matches
515	Ciprian Tătărușanu	ro ROU	GK	Milan	37-113	1986	16.0	0	0	0	0	0	0	0		0	0	0	0	1	1	2	0	Matches
516	Filippo Terracciano	it ITA	DF,MF	Hellas Verona	20-114	2003	9.1	20	13	11	7	2	15	20	75.0	5	7	4	3	10	30	14	0	Matches
517	Pietro Terracciano	it ITA	GK	Fiorentina	33-086	1990	29.0	2	1	2	0	0	2	3	66.7	1	0	0	0	1	3	14	0	Matches
518	Aleksa Terzić	rs SRB	DF	Fiorentina	23-289	1999	9.4	16	9	9	4	3	11	20	55.0	9	13	4	9	5	21	15	0	Matches
519	Florian Thauvin	fr FRA	FW,MF	Udinese	30-127	1993	5.2	2	1	0	2	0	2	13	15.4	11	5	0	5	1	3	2	0	Matches
520	Malick Thiaw	de GER	DF	Milan	21-298	2001	14.1	31	26	22	9	0	11	19	57.9	8	11	5	6	12	43	64	1	Matches
521	Kristian Thorstvedt	no NOR	MF	Sassuolo	24-081	1999	12.6	16	7	4	9	3	6	17	35.3	11	19	5	14	14	30	13	0	Matches
522	Jeremy Toljan	de GER	DF	Sassuolo	28-298	1994	28.7	36	23	17	14	5	22	33	66.7	11	31	14	17	18	54	57	1	Matches
523	Rafael Tolói	it ITA	DF	Atalanta	32-235	1990	29.9	68	43	37	31	0	34	62	54.8	28	39	18	21	57	125	86	1	Matches
524	Fikayo Tomori	eng ENG	DF	Milan	25-165	1997	29.7	70	34	44	25	1	22	33	66.7	11	46	25	21	28	98	86	1	Matches
525	Sandro Tonali	it ITA	MF	Milan	23-025	2000	29.1	64	41	35	24	5	27	44	61.4	17	34	9	25	25	89	24	1	Matches
526	Lorenzo Tonelli	it ITA	DF	Empoli	33-136	1990	0.2	0	0	0	0	0	0	1	0.0	1	0	0	0	0	0	0	0	Matches
527	William Troost-Ekong	ng NGA	DF	Salernitana	29-274	1993	4.9	11	3	7	4	0	6	7	85.7	1	6	4	2	6	17	10	0	Matches
528	Frank Tsadjout	it ITA	FW,MF	Cremonese	23-309	1999	11.2	10	8	3	6	1	3	9	33.3	6	7	1	6	8	18	9	0	Matches
529	Alessandro Tuia	it ITA	DF	Lecce	32-359	1990	5.7	10	6	6	4	0	3	9	33.3	6	3	1	2	15	25	29	0	Matches
530	Martin Turk	si SVN	GK	Sampdoria	19-285	2003	3.0	0	0	0	0	0	0	0		0	0	0	0	0	0	1	0	Matches
531	Iyenoma Udogie	it ITA	DF	Udinese	20-186	2002	29.0	70	44	41	24	5	33	56	58.9	23	34	6	28	35	105	25	0	Matches
532	Samuel Umtiti	fr FRA	DF	Lecce	29-200	1993	22.5	52	34	25	25	2	18	26	69.2	8	25	13	12	24	76	77	0	Matches
533	Diego Valencia	cl CHI	MF,FW	Salernitana	23-139	2000	2.6	8	5	4	2	2	2	9	22.2	7	10	1	9	1	9	2	0	Matches
534	Emanuele Valeri	it ITA	DF	Cremonese	24-177	1998	29.9	52	25	28	20	4	28	66	42.4	38	16	2	14	19	71	43	1	Matches
535	Mattia Valoti	it ITA	MF,FW	Monza	29-269	1993	5.0	17	10	7	9	1	5	16	31.3	11	13	3	10	3	20	6	0	Matches
536	Johan Vásquez	mx MEX	DF	Cremonese	24-223	1998	19.1	38	23	32	6	0	17	37	45.9	20	25	18	7	42	80	91	1	Matches
537	Matías Vecino	uy URU	MF	Lazio	31-282	1991	18.0	46	27	13	23	10	22	44	50.0	22	32	10	22	16	62	36	1	Matches
538	Miguel Veloso	pt POR	MF	Hellas Verona	37-022	1986	12.3	29	8	17	11	1	15	25	60.0	10	26	6	20	6	35	14	0	Matches
539	Lorenzo Venuti	it ITA	DF	Fiorentina	28-051	1995	10.1	18	7	6	11	1	11	18	61.1	7	7	2	5	5	23	17	2	Matches
540	Daniele Verde	it ITA	FW,MF	Spezia	26-347	1996	11.0	4	4	3	0	1	3	6	50.0	3	6	0	6	8	12	3	0	Matches
541	Simone Verdi	it ITA	MF,FW	Hellas Verona	30-325	1992	11.8	15	10	7	5	3	6	17	35.3	11	8	1	7	0	15	2	0	Matches
542	Valerio Verre	it ITA	MF	Sampdoria	29-142	1994	7.5	14	7	6	5	3	8	17	47.1	9	9	1	8	9	23	3	0	Matches
543	Guglielmo Vicario	it ITA	GK	Empoli	26-238	1996	30.0	1	1	1	0	0	1	2	50.0	1	0	0	0	0	1	15	2	Matches
544	Ronaldo Vieira	gw GNB	MF	Torino	24-318	1998	0.2		0											0				Matches
545	Ronaldo Vieira	gw GNB	MF	Sampdoria	24-318	1998	9.1		10											13				Matches
546	Emanuel Vignato	it ITA	MF,FW	Bologna	22-282	2000	2.7	4	4	2	2	0	2	4	50.0	2	2	0	2	3	7	0	0	Matches
547	Emanuel Vignato	it ITA	MF,FW	Empoli	22-282	2000	0.6	2	0	2	0	0	0	0		0	0	0	0	0	2	1	0	Matches
548	Samuele Vignato	it ITA	MF,FW	Monza	19-098	2004	0.7	0	0	0	0	0	0	0		0	1	0	1	0	0	0	0	Matches
549	Tonny Vilhena	nl NED	MF	Salernitana	28-150	1995	25.2	44	22	16	23	5	20	50	40.0	30	17	7	10	18	62	21	0	Matches
550	Gonzalo Villar	es ESP	MF	Sampdoria	25-071	1998	7.7	13	7	4	8	1	7	15	46.7	8	11	3	8	4	17	9	1	Matches
551	Matías Viña	uy URU	DF	Roma	25-205	1997	0.6	3	1	1	1	1	1	3	33.3	2	5	1	4	2	5	5	0	Matches
552	Dušan Vlahović	rs SRB	FW	Juventus	23-125	2000	21.4	11	6	0	7	4	4	10	40.0	6	10	3	7	3	14	8	1	Matches
553	Nikola Vlašić	hr CRO	MF,FW	Torino	25-241	1997	29.3	30	19	9	15	6	13	32	40.6	19	25	2	23	9	39	13	0	Matches
554	Joel Voelkerling Persson	se SWE	FW,MF	Lecce	20-138	2003	1.1	1	1	0	0	1	0	1	0.0	1	1	0	1	0	1	0	0	Matches
555	Mërgim Vojvoda	xk KVX	DF	Torino	28-121	1995	18.5	22	12	15	6	1	12	24	50.0	12	14	2	12	10	32	29	1	Matches
556	Cristian Volpato	it ITA	MF	Roma	19-199	2003	2.5	3	2	1	1	1	0	2	0.0	2	2	0	2	2	5	0	0	Matches
557	Lukáš Vorlický	cz CZE	MF,FW	Atalanta	21-135	2002	0.3	0	0	0	0	0	0	0		0	0	0	0	1	1	0	0	Matches
558	Aster Vranckx	be BEL	MF	Milan	20-241	2002	2.7	3	2	0	2	1	2	7	28.6	5	3	1	2	2	5	1	0	Matches
559	Stefan de Vrij	nl NED	DF	Inter	31-117	1992	20.6	28	18	19	9	0	8	13	61.5	5	17	10	7	38	66	76	0	Matches
560	Walace	br BRA	MF	Udinese	28-059	1995	34.9	81	38	41	31	9	41	90	45.6	49	47	12	35	50	131	48	1	Matches
561	Sebastian Walukiewicz	pl POL	DF	Empoli	23-058	2000	5.7	7	5	6	1	0	4	6	66.7	2	8	7	1	7	14	28	0	Matches
562	Georginio Wijnaldum	nl NED	MF	Roma	32-203	1990	8.4	4	3	1	3	0	0	1	0.0	1	6	1	5	2	6	2	0	Matches
563	Harry Winks	eng ENG	MF	Sampdoria	27-120	1996	19.1	27	12	7	18	2	14	43	32.6	29	14	8	6	24	51	24	0	Matches
564	Przemysław Wiśniewski	pl POL	DF	Spezia	24-310	1998	10.1	12	6	6	6	0	5	15	33.3	10	15	7	8	11	23	57	0	Matches
565	Gerard Yepes	es ESP	MF	Sampdoria	20-281	2002	2.2	5	3	2	3	0	1	3	33.3	2	3	0	3	4	9	3	0	Matches
566	Mattia Zaccagni	it ITA	FW	Lazio	27-351	1995	30.5	41	27	16	18	7	13	36	36.1	23	36	3	33	21	62	10	1	Matches
567	Denis Zakaria	ch SUI	MF	Juventus	26-194	1996	1.4	6	3	1	4	1	2	2	100.0	0	2	0	2	2	8	1	0	Matches
568	Nicola Zalewski	pl POL	DF	Roma	21-130	2002	23.4	43	26	24	15	4	21	70	30.0	49	26	1	25	30	73	20	0	Matches
569	Andre-Frank Zambo Anguissa	cm CMR	MF	Napoli	27-198	1995	33.0	53	32	16	29	8	16	63	25.4	47	50	4	46	46	99	25	0	Matches
570	Luca Zanimacchia	it ITA	MF,FW	Cremonese	24-318	1998	8.3	21	13	11	6	4	8	21	38.1	13	9	0	9	9	30	5	0	Matches
571	Nicolò Zaniolo	it ITA	MF,FW	Roma	23-335	1999	9.9	7	5	2	4	1	2	7	28.6	5	11	0	11	2	9	0	0	Matches
572	Alessandro Zanoli	it ITA	DF	Sampdoria	22-242	2000	16.1	20	13	12	6	2	6	15	40.0	9	17	14	3	10	30	35	0	Matches
573	Alessandro Zanoli	it ITA	DF	Napoli	22-242	2000	0.1	1	0	0	1	0	0	0		0	0	0	0	0	1	1	0	Matches
574	Mattia Zanotti	it ITA	DF	Inter	20-142	2003	0.3	0	0	0	0	0	0	1	0.0	1	2	0	2	0	0	0	0	Matches
575	Duván Zapata	co COL	FW	Atalanta	32-062	1991	15.5	8	4	1	3	4	3	5	60.0	2	6	2	4	4	12	17	1	Matches
576	Davide Zappacosta	it ITA	DF	Atalanta	30-356	1992	15.4	34	18	17	12	5	15	22	68.2	7	21	2	19	9	43	16	0	Matches
577	Karim Zedadka	fr FRA	FW	Napoli	22-358	2000	0.2	0	0	0	0	0	0	0		0	0	0	0	0	0	1	0	Matches
578	Deyovaisio Zeefuik	nl NED	DF	Hellas Verona	25-083	1998	0.1	1	1	0	1	0	0	0		0	0	0	0	0	1	0	0	Matches
579	Marvin Zeegelaar	nl NED	DF	Udinese	32-294	1990	3.9	8	4	6	2	0	3	4	75.0	1	2	0	2	3	11	5	0	Matches
580	Alessio Zerbin	it ITA	FW	Napoli	24-091	1999	2.2	10	5	4	5	1	4	8	50.0	4	2	0	2	2	12	2	0	Matches
581	Piotr Zieliński	pl POL	MF	Napoli	29-013	1994	24.7	16	9	1	11	4	11	24	45.8	13	16	5	11	14	30	7	0	Matches
582	David Zima	cz CZE	DF	Torino	22-206	2000	4.5	9	5	5	4	0	3	4	75.0	1	7	2	5	9	18	11	2	Matches
583	Joshua Zirkzee	nl NED	FW	Bologna	22-011	2001	8.9	4	2	1	1	2	2	7	28.6	5	4	1	3	4	8	4	0	Matches
584	Jeroen Zoet	nl NED	GK	Spezia	32-147	1991	2.7	1	1	1	0	0	1	1	100.0	0	0	0	0	0	1	0	0	Matches
585	Nadir Zortea	it ITA	DF,MF	Atalanta	23-348	1999	2.5	10	5	3	7	0	3	4	75.0	1	4	0	4	0	10	4	0	Matches
586	Nadir Zortea	it ITA	DF	Sassuolo	23-348	1999	7.3	15	8	12	2	1	9	14	64.3	5	10	4	6	4	19	21	0	Matches
587	Petar Zovko	ba BIH	GK	Spezia	21-069	2002	0.8	1	0	1	0	0	1	1	100.0	0	0	0	0	0	1	0	0	Matches
588	Szymon Żurkowski	pl POL	MF	Fiorentina	25-250	1997	0.4	0	0	0	0	0	0	0		0	0	0	0	0	0	0	0	Matches
589	Szymon Żurkowski	pl POL	MF	Spezia	25-250	1997	3.8	9	3	4	4	1	2	11	18.2	9	7	2	5	4	13	6	0	Matches
590	Milan Đurić	ba BIH	FW	Hellas Verona	33-011	1990	14.5	2	1	1	0	1	1	3	33.3	2	7	4	3	1	3	22	0	Matches
591	Filip Đuričić	rs SRB	MF,FW	Sampdoria	31-123	1992	24.1	43	22	18	20	5	14	32	43.8	18	19	6	13	7	50	8	0	Matches